PokerStars Hand #189421077633: Tournament #2367584539, 9000+1000 Hold'em No Limit - Level I (10/20) - 2018/08/01 21:15:02 ET
Table '2367584539 6' 9-max Seat #1 is the button
Seat 1: cleatus142 (1500 in chips) 
Seat 2: Pedja99 (1500 in chips) 
Seat 4: marcelito540 (1500 in chips) 
Seat 5: talesoliveir (1500 in chips) 
Seat 6: boyscout99 (1500 in chips) 
Seat 7: blaster772 (1500 in chips) 
Seat 8: thefish1948 (1500 in chips) 
Seat 9: hzane (1500 in chips) 
Pedja99: posts small blind 10
marcelito540: posts big blind 20
*** HOLE CARDS ***
Dealt to hzane [3c Th]
talesoliveir has timed out
talesoliveir: folds 
boyscout99: calls 20
blaster772: calls 20
thefish1948: calls 20
hzane: calls 20
cleatus142: calls 20
Pedja99: calls 10
marcelito540: raises 140 to 160
boyscout99: folds 
blaster772: calls 140
thefish1948: calls 140
hzane: folds 
cleatus142: folds 
Pedja99: calls 140
*** FLOP *** [2s 2h Ac]
Pedja99: checks 
marcelito540: checks 
blaster772: checks 
thefish1948: checks 
*** TURN *** [2s 2h Ac] [3d]
Pedja99: checks 
marcelito540: bets 200
blaster772: folds 
thefish1948: folds 
Pedja99: folds 
Uncalled bet (200) returned to marcelito540
marcelito540 collected 700 from pot
marcelito540: doesn't show hand 
*** SUMMARY ***
Total pot 700 | Rake 0 
Board [2s 2h Ac 3d]
Seat 1: cleatus142 (button) folded before Flop
Seat 2: Pedja99 (small blind) folded on the Turn
Seat 4: marcelito540 (big blind) collected (700)
Seat 5: talesoliveir folded before Flop (didn't bet)
Seat 6: boyscout99 folded before Flop
Seat 7: blaster772 folded on the Turn
Seat 8: thefish1948 folded on the Turn
Seat 9: hzane folded before Flop



PokerStars Hand #189421101441: Tournament #2367584539, 9000+1000 Hold'em No Limit - Level I (10/20) - 2018/08/01 21:16:09 ET
Table '2367584539 6' 9-max Seat #2 is the button
Seat 1: cleatus142 (1480 in chips) 
Seat 2: Pedja99 (1340 in chips) 
Seat 4: marcelito540 (2040 in chips) 
Seat 5: talesoliveir (1500 in chips) 
Seat 6: boyscout99 (1480 in chips) 
Seat 7: blaster772 (1340 in chips) 
Seat 8: thefish1948 (1340 in chips) 
Seat 9: hzane (1480 in chips) 
marcelito540: posts small blind 10
talesoliveir: posts big blind 20
*** HOLE CARDS ***
Dealt to hzane [5d 9d]
boyscout99: calls 20
blaster772: folds 
thefish1948: raises 20 to 40
hzane: calls 40
cleatus142: calls 40
Pedja99: calls 40
marcelito540: raises 320 to 360
talesoliveir: folds 
boyscout99: folds 
thefish1948: calls 320
hzane: folds 
cleatus142: calls 320
Pedja99: folds 
*** FLOP *** [Th 3c 8c]
marcelito540: bets 1200
thefish1948: calls 980 and is all-in
cleatus142: calls 1120 and is all-in
Uncalled bet (80) returned to marcelito540
*** TURN *** [Th 3c 8c] [2s]
*** RIVER *** [Th 3c 8c 2s] [4d]
*** SHOW DOWN ***
marcelito540: shows [As 8d] (a pair of Eights)
cleatus142: shows [2c Ac] (a pair of Deuces)
marcelito540 collected 280 from side pot
thefish1948: shows [Ad Td] (a pair of Tens)
thefish1948 collected 4140 from main pot
cleatus142 finished the tournament
*** SUMMARY ***
Total pot 4420 Main pot 4140. Side pot 280. | Rake 0 
Board [Th 3c 8c 2s 4d]
Seat 1: cleatus142 showed [2c Ac] and lost with a pair of Deuces
Seat 2: Pedja99 (button) folded before Flop
Seat 4: marcelito540 (small blind) showed [As 8d] and won (280) with a pair of Eights
Seat 5: talesoliveir (big blind) folded before Flop
Seat 6: boyscout99 folded before Flop
Seat 7: blaster772 folded before Flop (didn't bet)
Seat 8: thefish1948 showed [Ad Td] and won (4140) with a pair of Tens
Seat 9: hzane folded before Flop



PokerStars Hand #189421131600: Tournament #2367584539, 9000+1000 Hold'em No Limit - Level I (10/20) - 2018/08/01 21:17:22 ET
Table '2367584539 6' 9-max Seat #4 is the button
Seat 2: Pedja99 (1300 in chips) 
Seat 3: Wwyattearp (1500 in chips) 
Seat 4: marcelito540 (840 in chips) 
Seat 5: talesoliveir (1480 in chips) 
Seat 6: boyscout99 (1460 in chips) 
Seat 7: leebury1935 (2850 in chips) 
Seat 8: thefish1948 (4140 in chips) 
Seat 9: hzane (1440 in chips) 
talesoliveir: posts small blind 10
boyscout99: posts big blind 20
*** HOLE CARDS ***
Dealt to hzane [2h 4d]
leebury1935: calls 20
thefish1948: folds 
hzane: folds 
Pedja99: calls 20
Wwyattearp: folds 
marcelito540: raises 820 to 840 and is all-in
talesoliveir: folds 
boyscout99: raises 620 to 1460 and is all-in
leebury1935: folds 
Pedja99: folds 
Uncalled bet (620) returned to boyscout99
*** FLOP *** [Js Ac 2s]
*** TURN *** [Js Ac 2s] [7c]
*** RIVER *** [Js Ac 2s 7c] [4c]
*** SHOW DOWN ***
boyscout99: shows [As 6s] (a pair of Aces)
marcelito540: shows [Ts Jh] (a pair of Jacks)
boyscout99 collected 1730 from pot
marcelito540 finished the tournament
*** SUMMARY ***
Total pot 1730 | Rake 0 
Board [Js Ac 2s 7c 4c]
Seat 2: Pedja99 folded before Flop
Seat 3: Wwyattearp folded before Flop (didn't bet)
Seat 4: marcelito540 (button) showed [Ts Jh] and lost with a pair of Jacks
Seat 5: talesoliveir (small blind) folded before Flop
Seat 6: boyscout99 (big blind) showed [As 6s] and won (1730) with a pair of Aces
Seat 7: leebury1935 folded before Flop
Seat 8: thefish1948 folded before Flop (didn't bet)
Seat 9: hzane folded before Flop (didn't bet)



PokerStars Hand #189421141447: Tournament #2367584539, 9000+1000 Hold'em No Limit - Level I (10/20) - 2018/08/01 21:17:50 ET
Table '2367584539 6' 9-max Seat #5 is the button
Seat 1: zinho254 (1500 in chips) 
Seat 2: Pedja99 (1280 in chips) 
Seat 3: Wwyattearp (1500 in chips) 
Seat 5: talesoliveir (1470 in chips) 
Seat 6: boyscout99 (2350 in chips) 
Seat 8: thefish1948 (4140 in chips) 
Seat 9: hzane (1440 in chips) 
boyscout99: posts small blind 10
thefish1948: posts big blind 20
*** HOLE CARDS ***
Dealt to hzane [4d Th]
hzane: folds 
zinho254: calls 20
Pedja99: calls 20
Wwyattearp: calls 20
talesoliveir: folds 
boyscout99: calls 10
thefish1948: checks 
*** FLOP *** [6c Qh Kd]
boyscout99: checks 
thefish1948: bets 20
zinho254: calls 20
Pedja99: calls 20
Wwyattearp: folds 
boyscout99: calls 20
*** TURN *** [6c Qh Kd] [5d]
boyscout99: checks 
thefish1948: bets 20
zinho254: calls 20
Pedja99: calls 20
boyscout99: calls 20
*** RIVER *** [6c Qh Kd 5d] [Ah]
boyscout99: checks 
thefish1948: bets 20
zinho254: folds 
Pedja99: calls 20
boyscout99: calls 20
*** SHOW DOWN ***
thefish1948: shows [8c Qs] (a pair of Queens)
Pedja99: shows [Ac Td] (a pair of Aces)
boyscout99: mucks hand 
Pedja99 collected 320 from pot
*** SUMMARY ***
Total pot 320 | Rake 0 
Board [6c Qh Kd 5d Ah]
Seat 1: zinho254 folded on the River
Seat 2: Pedja99 showed [Ac Td] and won (320) with a pair of Aces
Seat 3: Wwyattearp folded on the Flop
Seat 5: talesoliveir (button) folded before Flop (didn't bet)
Seat 6: boyscout99 (small blind) mucked [Qc 7d]
Seat 8: thefish1948 (big blind) showed [8c Qs] and lost with a pair of Queens
Seat 9: hzane folded before Flop (didn't bet)



PokerStars Hand #189421160906: Tournament #2367584539, 9000+1000 Hold'em No Limit - Level II (12/24) - 2018/08/01 21:18:44 ET
Table '2367584539 17' 9-max Seat #1 is the button
Seat 1: hzane (1440 in chips) 
Seat 2: newplayer#30 (1500 in chips) 
Seat 3: tanaka321 (1490 in chips) 
Seat 5: tomasito540 (1500 in chips) 
Seat 6: DUDUCUNHAQC4 (1500 in chips) 
Seat 8: VaqueroHector (1500 in chips) 
newplayer#30: posts small blind 12
tanaka321: posts big blind 24
*** HOLE CARDS ***
Dealt to hzane [8h Qc]
tomasito540 is connected 
tomasito540: raises 1476 to 1500 and is all-in
DUDUCUNHAQC4: calls 1500 and is all-in
VaqueroHector: folds 
hzane: folds 
newplayer#30: folds 
tanaka321: calls 1466 and is all-in
*** FLOP *** [Qd Ac 4h]
*** TURN *** [Qd Ac 4h] [3d]
*** RIVER *** [Qd Ac 4h 3d] [8c]
*** SHOW DOWN ***
tomasito540: shows [Jd Ad] (a pair of Aces)
DUDUCUNHAQC4: shows [Kd 6d] (high card Ace)
tomasito540 collected 20 from side pot
tanaka321: shows [9d Qh] (a pair of Queens)
tomasito540 collected 4482 from main pot
DUDUCUNHAQC4 finished the tournament
tanaka321 finished the tournament
*** SUMMARY ***
Total pot 4502 Main pot 4482. Side pot 20. | Rake 0 
Board [Qd Ac 4h 3d 8c]
Seat 1: hzane (button) folded before Flop (didn't bet)
Seat 2: newplayer#30 (small blind) folded before Flop
Seat 3: tanaka321 (big blind) showed [9d Qh] and lost with a pair of Queens
Seat 5: tomasito540 showed [Jd Ad] and won (4502) with a pair of Aces
Seat 6: DUDUCUNHAQC4 showed [Kd 6d] and lost with high card Ace
Seat 8: VaqueroHector folded before Flop (didn't bet)



PokerStars Hand #189421170187: Tournament #2367584539, 9000+1000 Hold'em No Limit - Level II (12/24) - 2018/08/01 21:19:10 ET
Table '2367584539 17' 9-max Seat #2 is the button
Seat 1: hzane (1440 in chips) 
Seat 2: newplayer#30 (1488 in chips) 
Seat 8: VaqueroHector (1500 in chips) 
Seat 9: reche209 (1500 in chips) 
VaqueroHector: posts small blind 12
reche209: posts big blind 24
*** HOLE CARDS ***
Dealt to hzane [Th 4h]
hzane: calls 24
newplayer#30: folds 
VaqueroHector: calls 12
reche209: checks 
*** FLOP *** [6c 2s 8d]
VaqueroHector: checks 
reche209: checks 
hzane: bets 24
VaqueroHector: folds 
reche209: calls 24
*** TURN *** [6c 2s 8d] [Ad]
reche209: checks 
hzane: bets 72
reche209: folds 
Uncalled bet (72) returned to hzane
hzane collected 120 from pot
*** SUMMARY ***
Total pot 120 | Rake 0 
Board [6c 2s 8d Ad]
Seat 1: hzane collected (120)
Seat 2: newplayer#30 (button) folded before Flop (didn't bet)
Seat 8: VaqueroHector (small blind) folded on the Flop
Seat 9: reche209 (big blind) folded on the Turn



PokerStars Hand #189421193088: Tournament #2367584539, 9000+1000 Hold'em No Limit - Level II (12/24) - 2018/08/01 21:20:16 ET
Table '2367584539 17' 9-max Seat #8 is the button
Seat 1: hzane (1512 in chips) 
Seat 2: newplayer#30 (1488 in chips) 
Seat 3: celteee (1140 in chips) 
Seat 4: J3romy (1500 in chips) 
Seat 5: ogfred64 (1500 in chips) 
Seat 6: ShazanX (1500 in chips) 
Seat 7: RACING339 (1500 in chips) 
Seat 8: VaqueroHector (1476 in chips) 
Seat 9: reche209 (1452 in chips) 
reche209: posts small blind 12
hzane: posts big blind 24
*** HOLE CARDS ***
Dealt to hzane [Th 7d]
newplayer#30: calls 24
celteee: calls 24
J3romy: calls 24
ogfred64: folds 
ShazanX: raises 48 to 72
RACING339: folds 
VaqueroHector: folds 
reche209: raises 48 to 120
hzane: folds 
newplayer#30: calls 96
celteee: folds 
J3romy: folds 
ShazanX: calls 48
*** FLOP *** [8c 9d Js]
reche209: bets 24
newplayer#30: raises 1344 to 1368 and is all-in
ShazanX: folds 
reche209: folds 
Uncalled bet (1344) returned to newplayer#30
newplayer#30 collected 480 from pot
newplayer#30: doesn't show hand 
*** SUMMARY ***
Total pot 480 | Rake 0 
Board [8c 9d Js]
Seat 1: hzane (big blind) folded before Flop
Seat 2: newplayer#30 collected (480)
Seat 3: celteee folded before Flop
Seat 4: J3romy folded before Flop
Seat 5: ogfred64 folded before Flop (didn't bet)
Seat 6: ShazanX folded on the Flop
Seat 7: RACING339 folded before Flop (didn't bet)
Seat 8: VaqueroHector (button) folded before Flop (didn't bet)
Seat 9: reche209 (small blind) folded on the Flop



PokerStars Hand #189421213090: Tournament #2367584539, 9000+1000 Hold'em No Limit - Level III (14/28) - 2018/08/01 21:21:12 ET
Table '2367584539 17' 9-max Seat #9 is the button
Seat 1: hzane (1488 in chips) 
Seat 3: celteee (1116 in chips) 
Seat 4: J3romy (1476 in chips) 
Seat 5: ogfred64 (1500 in chips) 
Seat 6: ShazanX (1380 in chips) 
Seat 7: RACING339 (1500 in chips) 
Seat 8: VaqueroHector (1476 in chips) 
Seat 9: reche209 (1308 in chips) 
hzane: posts small blind 14
celteee: posts big blind 28
*** HOLE CARDS ***
Dealt to hzane [Th 2h]
J3romy: raises 56 to 84
ogfred64: folds 
ShazanX: calls 84
RACING339: calls 84
VaqueroHector: folds 
reche209: folds 
hzane: calls 70
celteee: folds 
*** FLOP *** [7d 7h 5d]
hzane: checks 
J3romy: checks 
ShazanX: bets 182
RACING339: folds 
hzane: folds 
J3romy: folds 
Uncalled bet (182) returned to ShazanX
ShazanX collected 364 from pot
ShazanX: doesn't show hand 
*** SUMMARY ***
Total pot 364 | Rake 0 
Board [7d 7h 5d]
Seat 1: hzane (small blind) folded on the Flop
Seat 3: celteee (big blind) folded before Flop
Seat 4: J3romy folded on the Flop
Seat 5: ogfred64 folded before Flop (didn't bet)
Seat 6: ShazanX collected (364)
Seat 7: RACING339 folded on the Flop
Seat 8: VaqueroHector folded before Flop (didn't bet)
Seat 9: reche209 (button) folded before Flop (didn't bet)



PokerStars Hand #189421232540: Tournament #2367584539, 9000+1000 Hold'em No Limit - Level III (14/28) - 2018/08/01 21:22:08 ET
Table '2367584539 17' 9-max Seat #1 is the button
Seat 1: hzane (1404 in chips) 
Seat 3: celteee (1088 in chips) 
Seat 4: J3romy (1392 in chips) 
Seat 5: ogfred64 (1500 in chips) 
Seat 6: ShazanX (1660 in chips) 
Seat 7: RACING339 (1416 in chips) 
Seat 8: VaqueroHector (1476 in chips) 
Seat 9: reche209 (1308 in chips) 
celteee: posts small blind 14
J3romy: posts big blind 28
*** HOLE CARDS ***
Dealt to hzane [3h 2c]
ogfred64: folds 
ShazanX: raises 56 to 84
RACING339: calls 84
VaqueroHector: calls 84
reche209: calls 84
hzane: folds 
celteee: folds 
J3romy: raises 1308 to 1392 and is all-in
ShazanX: folds 
RACING339: raises 24 to 1416 and is all-in
VaqueroHector: folds 
reche209: folds 
Uncalled bet (24) returned to RACING339
*** FLOP *** [Qh 5d Th]
*** TURN *** [Qh 5d Th] [Kh]
*** RIVER *** [Qh 5d Th Kh] [Js]
*** SHOW DOWN ***
J3romy: shows [3c 3d] (a pair of Threes)
RACING339: shows [8h Ks] (a pair of Kings)
RACING339 collected 3050 from pot
J3romy finished the tournament
*** SUMMARY ***
Total pot 3050 | Rake 0 
Board [Qh 5d Th Kh Js]
Seat 1: hzane (button) folded before Flop (didn't bet)
Seat 3: celteee (small blind) folded before Flop
Seat 4: J3romy (big blind) showed [3c 3d] and lost with a pair of Threes
Seat 5: ogfred64 folded before Flop (didn't bet)
Seat 6: ShazanX folded before Flop
Seat 7: RACING339 showed [8h Ks] and won (3050) with a pair of Kings
Seat 8: VaqueroHector folded before Flop
Seat 9: reche209 folded before Flop



PokerStars Hand #189421249554: Tournament #2367584539, 9000+1000 Hold'em No Limit - Level III (14/28) - 2018/08/01 21:22:56 ET
Table '2367584539 17' 9-max Seat #3 is the button
Seat 1: hzane (1404 in chips) 
Seat 2: nildaval (1500 in chips) 
Seat 3: celteee (1074 in chips) 
Seat 6: ShazanX (1576 in chips) 
Seat 7: RACING339 (3074 in chips) 
Seat 8: VaqueroHector (1392 in chips) 
Seat 9: reche209 (1224 in chips) 
ShazanX: posts small blind 14
RACING339: posts big blind 28
*** HOLE CARDS ***
Dealt to hzane [7h 5s]
VaqueroHector: calls 28
reche209: folds 
hzane: calls 28
nildaval: calls 28
celteee: folds 
ShazanX: calls 14
RACING339: checks 
*** FLOP *** [2c Kh 7s]
ShazanX: checks 
RACING339: bets 140
VaqueroHector: folds 
hzane: folds 
nildaval: calls 140
ShazanX: folds 
*** TURN *** [2c Kh 7s] [8d]
RACING339: bets 140
nildaval: folds 
Uncalled bet (140) returned to RACING339
RACING339 collected 420 from pot
*** SUMMARY ***
Total pot 420 | Rake 0 
Board [2c Kh 7s 8d]
Seat 1: hzane folded on the Flop
Seat 2: nildaval folded on the Turn
Seat 3: celteee (button) folded before Flop (didn't bet)
Seat 6: ShazanX (small blind) folded on the Flop
Seat 7: RACING339 (big blind) collected (420)
Seat 8: VaqueroHector folded on the Flop
Seat 9: reche209 folded before Flop (didn't bet)



PokerStars Hand #189421264289: Tournament #2367584539, 9000+1000 Hold'em No Limit - Level III (14/28) - 2018/08/01 21:23:38 ET
Table '2367584539 17' 9-max Seat #6 is the button
Seat 1: hzane (1376 in chips) 
Seat 2: nildaval (1332 in chips) 
Seat 3: celteee (1074 in chips) 
Seat 4: alexrosi696 (2952 in chips) 
Seat 5: heupamj (1500 in chips) 
Seat 6: ShazanX (1548 in chips) 
Seat 7: RACING339 (3326 in chips) 
Seat 8: VaqueroHector (1364 in chips) 
Seat 9: reche209 (1224 in chips) 
RACING339: posts small blind 14
VaqueroHector: posts big blind 28
*** HOLE CARDS ***
Dealt to hzane [2h 9h]
reche209: calls 28
hzane: folds 
nildaval: calls 28
celteee: calls 28
alexrosi696: calls 28
heupamj: calls 28
ShazanX: raises 84 to 112
RACING339: calls 98
VaqueroHector has timed out
VaqueroHector: folds 
reche209: raises 84 to 196
nildaval: folds 
celteee: folds 
alexrosi696: folds 
heupamj: calls 168
ShazanX: calls 84
RACING339: calls 84
*** FLOP *** [4h 4c Ts]
RACING339: checks 
reche209: bets 1028 and is all-in
heupamj: folds 
ShazanX: calls 1028
RACING339: folds 
*** TURN *** [4h 4c Ts] [Js]
*** RIVER *** [4h 4c Ts Js] [Kd]
*** SHOW DOWN ***
reche209: shows [7h Kh] (two pair, Kings and Fours)
ShazanX: shows [8s 8c] (two pair, Eights and Fours)
reche209 collected 2952 from pot
*** SUMMARY ***
Total pot 2952 | Rake 0 
Board [4h 4c Ts Js Kd]
Seat 1: hzane folded before Flop (didn't bet)
Seat 2: nildaval folded before Flop
Seat 3: celteee folded before Flop
Seat 4: alexrosi696 folded before Flop
Seat 5: heupamj folded on the Flop
Seat 6: ShazanX (button) showed [8s 8c] and lost with two pair, Eights and Fours
Seat 7: RACING339 (small blind) folded on the Flop
Seat 8: VaqueroHector (big blind) folded before Flop
Seat 9: reche209 showed [7h Kh] and won (2952) with two pair, Kings and Fours



PokerStars Hand #189421298003: Tournament #2367584539, 9000+1000 Hold'em No Limit - Level IV (16/32) - 2018/08/01 21:25:17 ET
Table '2367584539 17' 9-max Seat #7 is the button
Seat 1: hzane (1376 in chips) 
Seat 2: nildaval (1304 in chips) 
Seat 3: celteee (1046 in chips) 
Seat 4: alexrosi696 (2924 in chips) 
Seat 5: heupamj (1304 in chips) 
Seat 6: ShazanX (324 in chips) 
Seat 7: RACING339 (3130 in chips) 
Seat 8: VaqueroHector (1336 in chips) is sitting out
Seat 9: reche209 (2952 in chips) 
VaqueroHector: posts small blind 16
reche209: posts big blind 32
*** HOLE CARDS ***
Dealt to hzane [6d 7h]
hzane: folds 
nildaval: raises 32 to 64
VaqueroHector is disconnected 
celteee: folds 
alexrosi696: folds 
heupamj: folds 
ShazanX: raises 260 to 324 and is all-in
RACING339: folds 
VaqueroHector: folds 
reche209: folds 
nildaval: calls 260
*** FLOP *** [5d 2d 6h]
*** TURN *** [5d 2d 6h] [Js]
*** RIVER *** [5d 2d 6h Js] [9h]
*** SHOW DOWN ***
nildaval: shows [Kc Tc] (high card King)
ShazanX: shows [Ks Qc] (high card King - Queen kicker)
ShazanX collected 696 from pot
*** SUMMARY ***
Total pot 696 | Rake 0 
Board [5d 2d 6h Js 9h]
Seat 1: hzane folded before Flop (didn't bet)
Seat 2: nildaval showed [Kc Tc] and lost with high card King
Seat 3: celteee folded before Flop (didn't bet)
Seat 4: alexrosi696 folded before Flop (didn't bet)
Seat 5: heupamj folded before Flop (didn't bet)
Seat 6: ShazanX showed [Ks Qc] and won (696) with high card King
Seat 7: RACING339 (button) folded before Flop (didn't bet)
Seat 8: VaqueroHector (small blind) folded before Flop
Seat 9: reche209 (big blind) folded before Flop



PokerStars Hand #189421312400: Tournament #2367584539, 9000+1000 Hold'em No Limit - Level IV (16/32) - 2018/08/01 21:25:59 ET
Table '2367584539 26' 9-max Seat #1 is the button
Seat 1: hzane (1376 in chips) 
Seat 2: lochness89 (1760 in chips) 
Seat 3: dragica59 (6416 in chips) 
Seat 4: yoorpe (1276 in chips) 
Seat 5: Kacata955 (1500 in chips) 
Seat 6: HectorTorugo (1500 in chips) 
lochness89: posts small blind 16
dragica59: posts big blind 32
*** HOLE CARDS ***
Dealt to hzane [8d Td]
yoorpe is connected 
yoorpe: calls 32
Kacata955: calls 32
HectorTorugo: calls 32
hzane: raises 64 to 96
lochness89: folds 
dragica59: calls 64
yoorpe: calls 64
Kacata955: calls 64
HectorTorugo: calls 64
*** FLOP *** [Qh 6d 4h]
dragica59: bets 32
yoorpe: calls 32
Kacata955: calls 32
HectorTorugo: folds 
hzane: calls 32
*** TURN *** [Qh 6d 4h] [9c]
dragica59: checks 
yoorpe: checks 
Kacata955: bets 32
hzane: calls 32
dragica59: calls 32
yoorpe: calls 32
*** RIVER *** [Qh 6d 4h 9c] [5s]
dragica59: checks 
yoorpe: bets 128
Kacata955: calls 128
hzane: folds 
dragica59: folds 
*** SHOW DOWN ***
yoorpe: shows [9d Kh] (a pair of Nines)
Kacata955: mucks hand 
yoorpe collected 1008 from pot
*** SUMMARY ***
Total pot 1008 | Rake 0 
Board [Qh 6d 4h 9c 5s]
Seat 1: hzane (button) folded on the River
Seat 2: lochness89 (small blind) folded before Flop
Seat 3: dragica59 (big blind) folded on the River
Seat 4: yoorpe showed [9d Kh] and won (1008) with a pair of Nines
Seat 5: Kacata955 mucked [4s Kd]
Seat 6: HectorTorugo folded on the Flop



PokerStars Hand #189421345544: Tournament #2367584539, 9000+1000 Hold'em No Limit - Level V (20/40) - 2018/08/01 21:27:36 ET
Table '2367584539 26' 9-max Seat #2 is the button
Seat 1: hzane (1216 in chips) 
Seat 2: lochness89 (1744 in chips) 
Seat 3: dragica59 (6256 in chips) 
Seat 4: yoorpe (1996 in chips) 
Seat 5: Kacata955 (1212 in chips) 
Seat 6: HectorTorugo (1404 in chips) 
Seat 7: newplayer847 (1500 in chips) 
Seat 8: X3ee (1500 in chips) 
Seat 9: marianoycami (1500 in chips) 
hzane: posts the ante 4
lochness89: posts the ante 4
dragica59: posts the ante 4
yoorpe: posts the ante 4
Kacata955: posts the ante 4
HectorTorugo: posts the ante 4
newplayer847: posts the ante 4
X3ee: posts the ante 4
marianoycami: posts the ante 4
dragica59: posts small blind 20
yoorpe: posts big blind 40
*** HOLE CARDS ***
Dealt to hzane [Ks 9h]
Kacata955: calls 40
HectorTorugo has timed out
HectorTorugo: folds 
newplayer847: calls 40
X3ee: folds 
marianoycami: calls 40
hzane: calls 40
lochness89: folds 
dragica59: calls 20
yoorpe: checks 
*** FLOP *** [As 8s 9c]
dragica59: checks 
yoorpe: bets 40
Kacata955: raises 360 to 400
newplayer847: folds 
marianoycami: calls 400
hzane: folds 
dragica59: folds 
yoorpe: calls 360
*** TURN *** [As 8s 9c] [2s]
yoorpe: bets 40
Kacata955: raises 728 to 768 and is all-in
marianoycami: raises 288 to 1056 and is all-in
yoorpe: calls 1016
*** RIVER *** [As 8s 9c 2s] [6d]
*** SHOW DOWN ***
yoorpe: shows [Qs Ad] (a pair of Aces)
marianoycami: shows [Ts 6s] (a flush, Ace high)
marianoycami collected 576 from side pot
Kacata955: shows [2h 8h] (two pair, Eights and Deuces)
marianoycami collected 3780 from main pot
Kacata955 finished the tournament
*** SUMMARY ***
Total pot 4356 Main pot 3780. Side pot 576. | Rake 0 
Board [As 8s 9c 2s 6d]
Seat 1: hzane folded on the Flop
Seat 2: lochness89 (button) folded before Flop (didn't bet)
Seat 3: dragica59 (small blind) folded on the Flop
Seat 4: yoorpe (big blind) showed [Qs Ad] and lost with a pair of Aces
Seat 5: Kacata955 showed [2h 8h] and lost with two pair, Eights and Deuces
Seat 6: HectorTorugo folded before Flop (didn't bet)
Seat 7: newplayer847 folded on the Flop
Seat 8: X3ee folded before Flop (didn't bet)
Seat 9: marianoycami showed [Ts 6s] and won (4356) with a flush, Ace high



PokerStars Hand #189421373223: Tournament #2367584539, 9000+1000 Hold'em No Limit - Level V (20/40) - 2018/08/01 21:28:56 ET
Table '2367584539 26' 9-max Seat #3 is the button
Seat 1: hzane (1172 in chips) 
Seat 2: lochness89 (1740 in chips) 
Seat 3: dragica59 (6212 in chips) 
Seat 4: yoorpe (496 in chips) 
Seat 6: HectorTorugo (1400 in chips) 
Seat 7: newplayer847 (1456 in chips) 
Seat 8: X3ee (1496 in chips) 
Seat 9: marianoycami (4356 in chips) 
hzane: posts the ante 4
lochness89: posts the ante 4
dragica59: posts the ante 4
yoorpe: posts the ante 4
HectorTorugo: posts the ante 4
newplayer847: posts the ante 4
X3ee: posts the ante 4
marianoycami: posts the ante 4
yoorpe: posts small blind 20
HectorTorugo: posts big blind 40
*** HOLE CARDS ***
Dealt to hzane [7h Ad]
newplayer847: folds 
X3ee: folds 
marianoycami: calls 40
hzane: raises 40 to 80
lochness89: folds 
dragica59: folds 
yoorpe: raises 412 to 492 and is all-in
HectorTorugo has timed out
HectorTorugo: folds 
marianoycami: folds 
hzane: folds 
Uncalled bet (412) returned to yoorpe
yoorpe collected 272 from pot
yoorpe: doesn't show hand 
*** SUMMARY ***
Total pot 272 | Rake 0 
Seat 1: hzane folded before Flop
Seat 2: lochness89 folded before Flop (didn't bet)
Seat 3: dragica59 (button) folded before Flop (didn't bet)
Seat 4: yoorpe (small blind) collected (272)
Seat 6: HectorTorugo (big blind) folded before Flop
Seat 7: newplayer847 folded before Flop (didn't bet)
Seat 8: X3ee folded before Flop (didn't bet)
Seat 9: marianoycami folded before Flop



PokerStars Hand #189421387319: Tournament #2367584539, 9000+1000 Hold'em No Limit - Level V (20/40) - 2018/08/01 21:29:37 ET
Table '2367584539 26' 9-max Seat #4 is the button
Seat 1: hzane (1088 in chips) 
Seat 2: lochness89 (1736 in chips) 
Seat 3: dragica59 (6208 in chips) 
Seat 4: yoorpe (684 in chips) 
Seat 6: HectorTorugo (1356 in chips) is sitting out
Seat 7: newplayer847 (1452 in chips) 
Seat 8: X3ee (1492 in chips) 
Seat 9: marianoycami (4312 in chips) 
hzane: posts the ante 4
lochness89: posts the ante 4
dragica59: posts the ante 4
yoorpe: posts the ante 4
HectorTorugo: posts the ante 4
newplayer847: posts the ante 4
X3ee: posts the ante 4
marianoycami: posts the ante 4
HectorTorugo: posts small blind 20
newplayer847: posts big blind 40
*** HOLE CARDS ***
Dealt to hzane [8h 6d]
X3ee: calls 40
marianoycami: folds 
hzane: folds 
lochness89: folds 
dragica59: calls 40
yoorpe: calls 40
HectorTorugo: calls 20
newplayer847: checks 
*** FLOP *** [9d 2h Ad]
HectorTorugo: checks 
newplayer847: checks 
X3ee: checks 
dragica59: bets 40
yoorpe: calls 40
HectorTorugo has timed out
HectorTorugo: folds 
newplayer847: calls 40
X3ee: folds 
*** TURN *** [9d 2h Ad] [4s]
newplayer847: checks 
dragica59: bets 40
yoorpe: raises 40 to 80
newplayer847: calls 80
dragica59: calls 40
*** RIVER *** [9d 2h Ad 4s] [Kh]
newplayer847: checks 
dragica59: checks 
yoorpe: bets 40
newplayer847: folds 
dragica59: calls 40
*** SHOW DOWN ***
yoorpe: shows [2d 5s] (a pair of Deuces)
dragica59: shows [Kd Td] (a pair of Kings)
dragica59 collected 672 from pot
*** SUMMARY ***
Total pot 672 | Rake 0 
Board [9d 2h Ad 4s Kh]
Seat 1: hzane folded before Flop (didn't bet)
Seat 2: lochness89 folded before Flop (didn't bet)
Seat 3: dragica59 showed [Kd Td] and won (672) with a pair of Kings
Seat 4: yoorpe (button) showed [2d 5s] and lost with a pair of Deuces
Seat 6: HectorTorugo (small blind) folded on the Flop
Seat 7: newplayer847 (big blind) folded on the River
Seat 8: X3ee folded on the Flop
Seat 9: marianoycami folded before Flop (didn't bet)



PokerStars Hand #189421424832: Tournament #2367584539, 9000+1000 Hold'em No Limit - Level VI (25/50) - 2018/08/01 21:31:28 ET
Table '2367584539 26' 9-max Seat #6 is the button
Seat 1: hzane (1084 in chips) 
Seat 2: lochness89 (1732 in chips) 
Seat 3: dragica59 (6676 in chips) 
Seat 4: yoorpe (480 in chips) 
Seat 5: heuxaipae97 (1500 in chips) 
Seat 6: HectorTorugo (1312 in chips) is sitting out
Seat 7: newplayer847 (1288 in chips) 
Seat 8: X3ee (1448 in chips) 
Seat 9: marianoycami (4308 in chips) 
hzane: posts the ante 5
lochness89: posts the ante 5
dragica59: posts the ante 5
yoorpe: posts the ante 5
heuxaipae97: posts the ante 5
HectorTorugo: posts the ante 5
newplayer847: posts the ante 5
X3ee: posts the ante 5
marianoycami: posts the ante 5
newplayer847: posts small blind 25
X3ee: posts big blind 50
*** HOLE CARDS ***
Dealt to hzane [Qs 4h]
marianoycami: calls 50
hzane: folds 
lochness89: folds 
dragica59: folds 
yoorpe has timed out
yoorpe: folds 
heuxaipae97: folds 
HectorTorugo: folds 
newplayer847: calls 25
X3ee: checks 
*** FLOP *** [Th 6s 8d]
newplayer847: checks 
X3ee: checks 
marianoycami: bets 100
newplayer847: calls 100
X3ee: folds 
*** TURN *** [Th 6s 8d] [As]
newplayer847: checks 
marianoycami: bets 400
newplayer847: folds 
Uncalled bet (400) returned to marianoycami
marianoycami collected 395 from pot
*** SUMMARY ***
Total pot 395 | Rake 0 
Board [Th 6s 8d As]
Seat 1: hzane folded before Flop (didn't bet)
Seat 2: lochness89 folded before Flop (didn't bet)
Seat 3: dragica59 folded before Flop (didn't bet)
Seat 4: yoorpe folded before Flop (didn't bet)
Seat 5: heuxaipae97 folded before Flop (didn't bet)
Seat 6: HectorTorugo (button) folded before Flop (didn't bet)
Seat 7: newplayer847 (small blind) folded on the Turn
Seat 8: X3ee (big blind) folded on the Flop
Seat 9: marianoycami collected (395)



PokerStars Hand #189421449902: Tournament #2367584539, 9000+1000 Hold'em No Limit - Level VI (25/50) - 2018/08/01 21:32:32 ET
Table '2367584539 26' 9-max Seat #7 is the button
Seat 1: hzane (1079 in chips) 
Seat 2: lochness89 (1727 in chips) 
Seat 3: dragica59 (6671 in chips) 
Seat 4: yoorpe (475 in chips) is sitting out
Seat 5: heuxaipae97 (1495 in chips) 
Seat 6: HectorTorugo (1307 in chips) is sitting out
Seat 7: newplayer847 (1133 in chips) 
Seat 8: X3ee (1393 in chips) 
Seat 9: marianoycami (4548 in chips) 
hzane: posts the ante 5
lochness89: posts the ante 5
dragica59: posts the ante 5
yoorpe: posts the ante 5
heuxaipae97: posts the ante 5
HectorTorugo: posts the ante 5
newplayer847: posts the ante 5
X3ee: posts the ante 5
marianoycami: posts the ante 5
X3ee: posts small blind 25
marianoycami: posts big blind 50
*** HOLE CARDS ***
Dealt to hzane [Kc 7h]
hzane: calls 50
lochness89: folds 
dragica59: folds 
yoorpe: folds 
heuxaipae97: calls 50
HectorTorugo: folds 
newplayer847: folds 
X3ee: raises 600 to 650
marianoycami: folds 
hzane: folds 
heuxaipae97: raises 840 to 1490 and is all-in
X3ee: calls 738 and is all-in
Uncalled bet (102) returned to heuxaipae97
*** FLOP *** [4s 9d 8d]
*** TURN *** [4s 9d 8d] [2c]
*** RIVER *** [4s 9d 8d 2c] [Kd]
*** SHOW DOWN ***
X3ee: shows [Js Jc] (a pair of Jacks)
heuxaipae97: shows [Ac 6s] (high card Ace)
X3ee collected 2921 from pot
*** SUMMARY ***
Total pot 2921 | Rake 0 
Board [4s 9d 8d 2c Kd]
Seat 1: hzane folded before Flop
Seat 2: lochness89 folded before Flop (didn't bet)
Seat 3: dragica59 folded before Flop (didn't bet)
Seat 4: yoorpe folded before Flop (didn't bet)
Seat 5: heuxaipae97 showed [Ac 6s] and lost with high card Ace
Seat 6: HectorTorugo folded before Flop (didn't bet)
Seat 7: newplayer847 (button) folded before Flop (didn't bet)
Seat 8: X3ee (small blind) showed [Js Jc] and won (2921) with a pair of Jacks
Seat 9: marianoycami (big blind) folded before Flop



PokerStars Hand #189421466412: Tournament #2367584539, 9000+1000 Hold'em No Limit - Level VII (30/60) - 2018/08/01 21:33:21 ET
Table '2367584539 26' 9-max Seat #8 is the button
Seat 1: hzane (1024 in chips) 
Seat 2: lochness89 (1722 in chips) 
Seat 3: dragica59 (6666 in chips) 
Seat 4: yoorpe (470 in chips) is sitting out
Seat 6: HectorTorugo (1302 in chips) is sitting out
Seat 7: newplayer847 (1128 in chips) 
Seat 8: X3ee (2921 in chips) 
Seat 9: marianoycami (4493 in chips) 
hzane: posts the ante 6
lochness89: posts the ante 6
dragica59: posts the ante 6
yoorpe: posts the ante 6
HectorTorugo: posts the ante 6
newplayer847: posts the ante 6
X3ee: posts the ante 6
marianoycami: posts the ante 6
marianoycami: posts small blind 30
hzane: posts big blind 60
*** HOLE CARDS ***
Dealt to hzane [9s 8h]
lochness89: calls 60
dragica59: calls 60
yoorpe: folds 
HectorTorugo: folds 
newplayer847: calls 60
X3ee: calls 60
marianoycami: calls 30
hzane: checks 
*** FLOP *** [Kc 2d Qc]
marianoycami: checks 
hzane: checks 
lochness89: checks 
dragica59: checks 
newplayer847: bets 60
X3ee: folds 
marianoycami: calls 60
hzane: folds 
lochness89: calls 60
dragica59: calls 60
*** TURN *** [Kc 2d Qc] [Qh]
marianoycami: checks 
lochness89: checks 
dragica59: checks 
newplayer847: bets 60
marianoycami: calls 60
lochness89: calls 60
dragica59: calls 60
*** RIVER *** [Kc 2d Qc Qh] [6d]
marianoycami: checks 
lochness89: checks 
dragica59: checks 
newplayer847: checks 
*** SHOW DOWN ***
marianoycami: shows [Kh 4h] (two pair, Kings and Queens)
lochness89: mucks hand 
dragica59: mucks hand 
newplayer847: mucks hand 
marianoycami collected 888 from pot
*** SUMMARY ***
Total pot 888 | Rake 0 
Board [Kc 2d Qc Qh 6d]
Seat 1: hzane (big blind) folded on the Flop
Seat 2: lochness89 mucked [Ad Td]
Seat 3: dragica59 mucked [Ah Jh]
Seat 4: yoorpe folded before Flop (didn't bet)
Seat 6: HectorTorugo folded before Flop (didn't bet)
Seat 7: newplayer847 mucked [Ac 7s]
Seat 8: X3ee (button) folded on the Flop
Seat 9: marianoycami (small blind) showed [Kh 4h] and won (888) with two pair, Kings and Queens



PokerStars Hand #189421496051: Tournament #2367584539, 9000+1000 Hold'em No Limit - Level VII (30/60) - 2018/08/01 21:34:49 ET
Table '2367584539 26' 9-max Seat #9 is the button
Seat 1: hzane (958 in chips) 
Seat 2: lochness89 (1536 in chips) 
Seat 3: dragica59 (6480 in chips) 
Seat 4: yoorpe (464 in chips) is sitting out
Seat 5: maike123229 (1500 in chips) 
Seat 6: HectorTorugo (1296 in chips) is sitting out
Seat 7: newplayer847 (942 in chips) 
Seat 8: X3ee (2855 in chips) 
Seat 9: marianoycami (5195 in chips) 
hzane: posts the ante 6
lochness89: posts the ante 6
dragica59: posts the ante 6
yoorpe: posts the ante 6
maike123229: posts the ante 6
HectorTorugo: posts the ante 6
newplayer847: posts the ante 6
X3ee: posts the ante 6
marianoycami: posts the ante 6
hzane: posts small blind 30
lochness89: posts big blind 60
*** HOLE CARDS ***
Dealt to hzane [Jd Ad]
dragica59: folds 
yoorpe: calls 60
maike123229: calls 60
HectorTorugo: folds 
newplayer847: calls 60
X3ee: calls 60
marianoycami: calls 60
hzane: raises 180 to 240
lochness89: folds 
yoorpe: calls 180
maike123229: calls 180
newplayer847: raises 180 to 420
X3ee: folds 
marianoycami: calls 360
hzane: raises 532 to 952 and is all-in
yoorpe: calls 218 and is all-in
maike123229: raises 532 to 1484
newplayer847: folds 
marianoycami: calls 1064
*** FLOP *** [3d Ks 7d]
maike123229: checks 
marianoycami: checks 
*** TURN *** [3d Ks 7d] [9d]
maike123229: checks 
marianoycami: bets 60
maike123229: calls 10 and is all-in
Uncalled bet (50) returned to marianoycami
*** RIVER *** [3d Ks 7d 9d] [9c]
*** SHOW DOWN ***
maike123229: shows [Kh Qc] (two pair, Kings and Nines)
marianoycami: shows [2h Ah] (a pair of Nines)
maike123229 collected 1084 from side pot-2 
hzane: shows [Jd Ad] (a flush, Ace high)
hzane collected 1482 from side pot-1 
yoorpe: shows [Ac Tc] (a pair of Nines)
hzane collected 2426 from main pot
yoorpe finished the tournament in 301st place
*** SUMMARY ***
Total pot 4992 Main pot 2426. Side pot-1 1482. Side pot-2 1084. | Rake 0 
Board [3d Ks 7d 9d 9c]
Seat 1: hzane (small blind) showed [Jd Ad] and won (3908) with a flush, Ace high
Seat 2: lochness89 (big blind) folded before Flop
Seat 3: dragica59 folded before Flop (didn't bet)
Seat 4: yoorpe showed [Ac Tc] and lost with a pair of Nines
Seat 5: maike123229 showed [Kh Qc] and won (1084) with two pair, Kings and Nines
Seat 6: HectorTorugo folded before Flop (didn't bet)
Seat 7: newplayer847 folded before Flop
Seat 8: X3ee folded before Flop
Seat 9: marianoycami (button) showed [2h Ah] and lost with a pair of Nines



PokerStars Hand #189421525345: Tournament #2367584539, 9000+1000 Hold'em No Limit - Level VIII (35/70) - 2018/08/01 21:36:15 ET
Table '2367584539 26' 9-max Seat #1 is the button
Seat 1: hzane (3908 in chips) 
Seat 2: lochness89 (1470 in chips) 
Seat 3: dragica59 (6474 in chips) 
Seat 5: maike123229 (1084 in chips) 
Seat 6: HectorTorugo (1290 in chips) is sitting out
Seat 7: newplayer847 (516 in chips) 
Seat 8: X3ee (2789 in chips) 
Seat 9: marianoycami (3695 in chips) 
hzane: posts the ante 7
lochness89: posts the ante 7
dragica59: posts the ante 7
maike123229: posts the ante 7
HectorTorugo: posts the ante 7
newplayer847: posts the ante 7
X3ee: posts the ante 7
marianoycami: posts the ante 7
lochness89: posts small blind 35
dragica59: posts big blind 70
*** HOLE CARDS ***
Dealt to hzane [7c 2h]
maike123229: calls 70
HectorTorugo: folds 
newplayer847: raises 70 to 140
X3ee: calls 140
marianoycami: calls 140
hzane: folds 
lochness89: folds 
dragica59: folds 
maike123229: calls 70
*** FLOP *** [4h Th 6c]
maike123229: checks 
newplayer847: checks 
X3ee: bets 361
marianoycami: calls 361
maike123229: calls 361
newplayer847: folds 
*** TURN *** [4h Th 6c] [Js]
maike123229: checks 
X3ee: checks 
marianoycami: bets 3187 and is all-in
maike123229: folds 
X3ee: calls 2281 and is all-in
Uncalled bet (906) returned to marianoycami
*** RIVER *** [4h Th 6c Js] [Kc]
*** SHOW DOWN ***
X3ee: shows [Tc Ad] (a pair of Tens)
marianoycami: shows [Qc 9s] (a straight, Nine to King)
marianoycami collected 6366 from pot
X3ee finished the tournament in 287th place
*** SUMMARY ***
Total pot 6366 | Rake 0 
Board [4h Th 6c Js Kc]
Seat 1: hzane (button) folded before Flop (didn't bet)
Seat 2: lochness89 (small blind) folded before Flop
Seat 3: dragica59 (big blind) folded before Flop
Seat 5: maike123229 folded on the Turn
Seat 6: HectorTorugo folded before Flop (didn't bet)
Seat 7: newplayer847 folded on the Flop
Seat 8: X3ee showed [Tc Ad] and lost with a pair of Tens
Seat 9: marianoycami showed [Qc 9s] and won (6366) with a straight, Nine to King



PokerStars Hand #189421553257: Tournament #2367584539, 9000+1000 Hold'em No Limit - Level VIII (35/70) - 2018/08/01 21:37:36 ET
Table '2367584539 26' 9-max Seat #2 is the button
Seat 1: hzane (3901 in chips) 
Seat 2: lochness89 (1428 in chips) 
Seat 3: dragica59 (6397 in chips) 
Seat 4: resarfnitram (1428 in chips) 
Seat 5: maike123229 (576 in chips) 
Seat 6: HectorTorugo (1283 in chips) is sitting out
Seat 7: newplayer847 (369 in chips) 
Seat 9: marianoycami (7272 in chips) 
hzane: posts the ante 7
lochness89: posts the ante 7
dragica59: posts the ante 7
resarfnitram: posts the ante 7
maike123229: posts the ante 7
HectorTorugo: posts the ante 7
newplayer847: posts the ante 7
marianoycami: posts the ante 7
dragica59: posts small blind 35
resarfnitram: posts big blind 70
*** HOLE CARDS ***
Dealt to hzane [2s As]
maike123229: folds 
HectorTorugo: folds 
newplayer847: folds 
marianoycami: raises 140 to 210
hzane: calls 210
lochness89: folds 
dragica59: folds 
resarfnitram: folds 
*** FLOP *** [8c Js 4d]
marianoycami: bets 280
hzane: calls 280
*** TURN *** [8c Js 4d] [4h]
marianoycami: bets 560
hzane: folds 
Uncalled bet (560) returned to marianoycami
marianoycami collected 1141 from pot
*** SUMMARY ***
Total pot 1141 | Rake 0 
Board [8c Js 4d 4h]
Seat 1: hzane folded on the Turn
Seat 2: lochness89 (button) folded before Flop (didn't bet)
Seat 3: dragica59 (small blind) folded before Flop
Seat 4: resarfnitram (big blind) folded before Flop
Seat 5: maike123229 folded before Flop (didn't bet)
Seat 6: HectorTorugo folded before Flop (didn't bet)
Seat 7: newplayer847 folded before Flop (didn't bet)
Seat 9: marianoycami collected (1141)



PokerStars Hand #189421573600: Tournament #2367584539, 9000+1000 Hold'em No Limit - Level VIII (35/70) - 2018/08/01 21:38:36 ET
Table '2367584539 26' 9-max Seat #3 is the button
Seat 1: hzane (3404 in chips) 
Seat 2: lochness89 (1421 in chips) 
Seat 3: dragica59 (6355 in chips) 
Seat 4: resarfnitram (1351 in chips) 
Seat 5: maike123229 (569 in chips) 
Seat 6: HectorTorugo (1276 in chips) is sitting out
Seat 7: newplayer847 (362 in chips) 
Seat 8: reche209 (1796 in chips) 
Seat 9: marianoycami (7916 in chips) 
hzane: posts the ante 7
lochness89: posts the ante 7
dragica59: posts the ante 7
resarfnitram: posts the ante 7
maike123229: posts the ante 7
HectorTorugo: posts the ante 7
newplayer847: posts the ante 7
reche209: posts the ante 7
marianoycami: posts the ante 7
resarfnitram: posts small blind 35
maike123229: posts big blind 70
*** HOLE CARDS ***
Dealt to hzane [8h 7d]
HectorTorugo: folds 
newplayer847: raises 70 to 140
reche209: raises 210 to 350
marianoycami: calls 350
hzane: folds 
lochness89: folds 
dragica59: folds 
resarfnitram: folds 
maike123229: folds 
newplayer847: raises 5 to 355 and is all-in
reche209: calls 5
marianoycami: calls 5
*** FLOP *** [8c 2d Ah]
reche209: bets 70
marianoycami: calls 70
*** TURN *** [8c 2d Ah] [4d]
reche209: bets 280
marianoycami: calls 280
*** RIVER *** [8c 2d Ah 4d] [Th]
reche209: checks 
marianoycami: bets 980
reche209: folds 
Uncalled bet (980) returned to marianoycami
*** SHOW DOWN ***
marianoycami: shows [2h 3h] (a pair of Deuces)
marianoycami collected 700 from side pot
newplayer847: shows [Kh 6s] (high card Ace)
marianoycami collected 1233 from main pot
newplayer847 finished the tournament in 266th place
*** SUMMARY ***
Total pot 1933 Main pot 1233. Side pot 700. | Rake 0 
Board [8c 2d Ah 4d Th]
Seat 1: hzane folded before Flop (didn't bet)
Seat 2: lochness89 folded before Flop (didn't bet)
Seat 3: dragica59 (button) folded before Flop (didn't bet)
Seat 4: resarfnitram (small blind) folded before Flop
Seat 5: maike123229 (big blind) folded before Flop
Seat 6: HectorTorugo folded before Flop (didn't bet)
Seat 7: newplayer847 showed [Kh 6s] and lost with high card Ace
Seat 8: reche209 folded on the River
Seat 9: marianoycami showed [2h 3h] and won (1933) with a pair of Deuces



PokerStars Hand #189421600636: Tournament #2367584539, 9000+1000 Hold'em No Limit - Level IX (40/80) - 2018/08/01 21:39:55 ET
Table '2367584539 26' 9-max Seat #4 is the button
Seat 1: hzane (3397 in chips) 
Seat 2: lochness89 (1414 in chips) 
Seat 3: dragica59 (6348 in chips) 
Seat 4: resarfnitram (1309 in chips) 
Seat 5: maike123229 (492 in chips) 
Seat 6: HectorTorugo (1269 in chips) is sitting out
Seat 8: reche209 (1084 in chips) 
Seat 9: marianoycami (9137 in chips) 
hzane: posts the ante 8
lochness89: posts the ante 8
dragica59: posts the ante 8
resarfnitram: posts the ante 8
maike123229: posts the ante 8
HectorTorugo: posts the ante 8
reche209: posts the ante 8
marianoycami: posts the ante 8
maike123229: posts small blind 40
HectorTorugo: posts big blind 80
*** HOLE CARDS ***
Dealt to hzane [As 4s]
reche209: folds 
marianoycami: calls 80
hzane: calls 80
lochness89: folds 
dragica59: folds 
resarfnitram: calls 80
maike123229: calls 40
HectorTorugo: folds 
*** FLOP *** [4h 3h Jh]
maike123229: checks 
marianoycami: bets 80
hzane: raises 312 to 392
resarfnitram: folds 
maike123229: folds 
marianoycami: calls 312
*** TURN *** [4h 3h Jh] [Jd]
marianoycami: bets 80
hzane: raises 320 to 400
marianoycami: calls 320
*** RIVER *** [4h 3h Jh Jd] [Th]
marianoycami: bets 80
hzane: calls 80
*** SHOW DOWN ***
marianoycami: shows [Tc 8h] (a flush, Jack high)
hzane: mucks hand 
marianoycami collected 2208 from pot
*** SUMMARY ***
Total pot 2208 | Rake 0 
Board [4h 3h Jh Jd Th]
Seat 1: hzane mucked [As 4s]
Seat 2: lochness89 folded before Flop (didn't bet)
Seat 3: dragica59 folded before Flop (didn't bet)
Seat 4: resarfnitram (button) folded on the Flop
Seat 5: maike123229 (small blind) folded on the Flop
Seat 6: HectorTorugo (big blind) folded before Flop
Seat 8: reche209 folded before Flop (didn't bet)
Seat 9: marianoycami showed [Tc 8h] and won (2208) with a flush, Jack high



PokerStars Hand #189421626407: Tournament #2367584539, 9000+1000 Hold'em No Limit - Level IX (40/80) - 2018/08/01 21:41:09 ET
Table '2367584539 26' 9-max Seat #5 is the button
Seat 1: hzane (2437 in chips) 
Seat 2: lochness89 (1406 in chips) 
Seat 3: dragica59 (6340 in chips) 
Seat 4: resarfnitram (1221 in chips) 
Seat 5: maike123229 (404 in chips) 
Seat 6: HectorTorugo (1181 in chips) is sitting out
Seat 7: tins (20135 in chips) 
Seat 8: reche209 (1076 in chips) 
Seat 9: marianoycami (10385 in chips) 
hzane: posts the ante 8
lochness89: posts the ante 8
dragica59: posts the ante 8
resarfnitram: posts the ante 8
maike123229: posts the ante 8
HectorTorugo: posts the ante 8
tins: posts the ante 8
reche209: posts the ante 8
marianoycami: posts the ante 8
HectorTorugo: posts small blind 40
tins: posts big blind 80
*** HOLE CARDS ***
Dealt to hzane [7h Kh]
reche209: calls 80
marianoycami: calls 80
hzane: calls 80
lochness89: folds 
dragica59: folds 
resarfnitram: folds 
maike123229: calls 80
HectorTorugo: folds 
tins: checks 
*** FLOP *** [8s Td 6c]
tins: bets 256
reche209: folds 
marianoycami: calls 256
hzane: folds 
maike123229: folds 
*** TURN *** [8s Td 6c] [2h]
tins: bets 512
marianoycami: calls 512
*** RIVER *** [8s Td 6c 2h] [4c]
tins: bets 480
marianoycami: calls 480
*** SHOW DOWN ***
tins: shows [9c 8c] (a pair of Eights)
marianoycami: shows [5s Th] (a pair of Tens)
marianoycami collected 3008 from pot
*** SUMMARY ***
Total pot 3008 | Rake 0 
Board [8s Td 6c 2h 4c]
Seat 1: hzane folded on the Flop
Seat 2: lochness89 folded before Flop (didn't bet)
Seat 3: dragica59 folded before Flop (didn't bet)
Seat 4: resarfnitram folded before Flop (didn't bet)
Seat 5: maike123229 (button) folded on the Flop
Seat 6: HectorTorugo (small blind) folded before Flop
Seat 7: tins (big blind) showed [9c 8c] and lost with a pair of Eights
Seat 8: reche209 folded on the Flop
Seat 9: marianoycami showed [5s Th] and won (3008) with a pair of Tens



PokerStars Hand #189421651394: Tournament #2367584539, 9000+1000 Hold'em No Limit - Level X (50/100) - 2018/08/01 21:42:23 ET
Table '2367584539 26' 9-max Seat #6 is the button
Seat 1: hzane (2349 in chips) 
Seat 2: lochness89 (1398 in chips) 
Seat 3: dragica59 (6332 in chips) 
Seat 4: resarfnitram (1213 in chips) 
Seat 5: maike123229 (316 in chips) 
Seat 6: HectorTorugo (1133 in chips) is sitting out
Seat 7: tins (18799 in chips) 
Seat 8: reche209 (988 in chips) 
Seat 9: marianoycami (12057 in chips) 
hzane: posts the ante 10
lochness89: posts the ante 10
dragica59: posts the ante 10
resarfnitram: posts the ante 10
maike123229: posts the ante 10
HectorTorugo: posts the ante 10
tins: posts the ante 10
reche209: posts the ante 10
marianoycami: posts the ante 10
tins: posts small blind 50
reche209: posts big blind 100
*** HOLE CARDS ***
Dealt to hzane [Qh Jh]
marianoycami: folds 
hzane: raises 100 to 200
lochness89: calls 200
dragica59: folds 
resarfnitram: calls 200
maike123229: calls 200
HectorTorugo: folds 
tins: raises 1190 to 1390
reche209: calls 878 and is all-in
hzane: calls 1190
lochness89: calls 1188 and is all-in
resarfnitram: calls 1003 and is all-in
maike123229: calls 106 and is all-in
*** FLOP *** [7d Qs Js]
tins: bets 3373
hzane: calls 949 and is all-in
Uncalled bet (2424) returned to tins
*** TURN *** [7d Qs Js] [4c]
*** RIVER *** [7d Qs Js 4c] [6d]
*** SHOW DOWN ***
tins: shows [8d Ah] (high card Ace)
hzane: shows [Qh Jh] (two pair, Queens and Jacks)
hzane collected 1902 from side pot-4 
lochness89: shows [Tc Ts] (a pair of Tens)
hzane collected 555 from side pot-3 
resarfnitram: shows [Ad 8s] (high card Ace)
hzane collected 900 from side pot-2 
reche209: shows [Kc 8c] (high card King)
hzane collected 3360 from side pot-1 
maike123229: shows [Kd 9c] (high card King)
hzane collected 1926 from main pot
lochness89 finished the tournament in 223rd place
resarfnitram finished the tournament in 224th place
reche209 finished the tournament in 225th place
maike123229 finished the tournament in 226th place
*** SUMMARY ***
Total pot 8643 Main pot 1926. Side pot-1 3360. Side pot-2 900. Side pot-3 555. Side pot-4 1902. | Rake 0 
Board [7d Qs Js 4c 6d]
Seat 1: hzane showed [Qh Jh] and won (8643) with two pair, Queens and Jacks
Seat 2: lochness89 showed [Tc Ts] and lost with a pair of Tens
Seat 3: dragica59 folded before Flop (didn't bet)
Seat 4: resarfnitram showed [Ad 8s] and lost with high card Ace
Seat 5: maike123229 showed [Kd 9c] and lost with high card King
Seat 6: HectorTorugo (button) folded before Flop (didn't bet)
Seat 7: tins (small blind) showed [8d Ah] and lost with high card Ace
Seat 8: reche209 (big blind) showed [Kc 8c] and lost with high card King
Seat 9: marianoycami folded before Flop (didn't bet)



PokerStars Hand #189421685434: Tournament #2367584539, 9000+1000 Hold'em No Limit - Level X (50/100) - 2018/08/01 21:44:05 ET
Table '2367584539 20' 9-max Seat #9 is the button
Seat 1: victor_tda (1103 in chips) is sitting out
Seat 3: hzane (8643 in chips) 
Seat 4: Mr. Amarelex (5027 in chips) 
Seat 5: roywjr (4710 in chips) 
Seat 6: pocketstuff (1618 in chips) 
Seat 7: hugo133813 (1235 in chips) 
Seat 8: Juarez1974 (2609 in chips) 
Seat 9: poony53 (4631 in chips) 
victor_tda: posts the ante 10
hzane: posts the ante 10
Mr. Amarelex: posts the ante 10
roywjr: posts the ante 10
pocketstuff: posts the ante 10
hugo133813: posts the ante 10
Juarez1974: posts the ante 10
poony53: posts the ante 10
victor_tda: posts small blind 50
hzane: posts big blind 100
*** HOLE CARDS ***
Dealt to hzane [3s 6s]
Mr. Amarelex: folds 
roywjr: folds 
pocketstuff: calls 100
hugo133813 is connected 
hugo133813: folds 
Juarez1974: raises 100 to 200
poony53: folds 
victor_tda: folds 
hzane: raises 100 to 300
pocketstuff: calls 200
Juarez1974: calls 100
*** FLOP *** [3d 3c Qd]
hzane: bets 100
pocketstuff: calls 100
Juarez1974: calls 100
*** TURN *** [3d 3c Qd] [Th]
hzane: checks 
pocketstuff: checks 
Juarez1974: bets 700
hzane: calls 700
pocketstuff: folds 
*** RIVER *** [3d 3c Qd Th] [Jd]
hzane: bets 300
Juarez1974: raises 1199 to 1499 and is all-in
hzane: calls 1199
*** SHOW DOWN ***
Juarez1974: shows [7c Ac] (a pair of Threes)
hzane: shows [3s 6s] (three of a kind, Threes)
hzane collected 5728 from pot
Juarez1974 finished the tournament in 206th place
*** SUMMARY ***
Total pot 5728 | Rake 0 
Board [3d 3c Qd Th Jd]
Seat 1: victor_tda (small blind) folded before Flop
Seat 3: hzane (big blind) showed [3s 6s] and won (5728) with three of a kind, Threes
Seat 4: Mr. Amarelex folded before Flop (didn't bet)
Seat 5: roywjr folded before Flop (didn't bet)
Seat 6: pocketstuff folded on the Turn
Seat 7: hugo133813 folded before Flop (didn't bet)
Seat 8: Juarez1974 showed [7c Ac] and lost with a pair of Threes
Seat 9: poony53 (button) folded before Flop (didn't bet)



PokerStars Hand #189421712377: Tournament #2367584539, 9000+1000 Hold'em No Limit - Level XI (60/120) - 2018/08/01 21:45:25 ET
Table '2367584539 20' 9-max Seat #1 is the button
Seat 1: victor_tda (1043 in chips) is sitting out
Seat 3: hzane (11762 in chips) 
Seat 4: Mr. Amarelex (5017 in chips) 
Seat 5: roywjr (4700 in chips) 
Seat 6: pocketstuff (1208 in chips) 
Seat 7: hugo133813 (1225 in chips) 
Seat 9: poony53 (4621 in chips) 
victor_tda: posts the ante 12
hzane: posts the ante 12
Mr. Amarelex: posts the ante 12
roywjr: posts the ante 12
pocketstuff: posts the ante 12
hugo133813: posts the ante 12
poony53: posts the ante 12
hzane: posts small blind 60
Mr. Amarelex: posts big blind 120
*** HOLE CARDS ***
Dealt to hzane [Qs 6d]
roywjr: folds 
pocketstuff: folds 
hugo133813: folds 
poony53: folds 
victor_tda: folds 
hzane: calls 60
Mr. Amarelex: checks 
*** FLOP *** [4h 3s 6c]
hzane: bets 120
Mr. Amarelex: folds 
Uncalled bet (120) returned to hzane
hzane collected 324 from pot
*** SUMMARY ***
Total pot 324 | Rake 0 
Board [4h 3s 6c]
Seat 1: victor_tda (button) folded before Flop (didn't bet)
Seat 3: hzane (small blind) collected (324)
Seat 4: Mr. Amarelex (big blind) folded on the Flop
Seat 5: roywjr folded before Flop (didn't bet)
Seat 6: pocketstuff folded before Flop (didn't bet)
Seat 7: hugo133813 folded before Flop (didn't bet)
Seat 9: poony53 folded before Flop (didn't bet)



PokerStars Hand #189421718975: Tournament #2367584539, 9000+1000 Hold'em No Limit - Level XI (60/120) - 2018/08/01 21:45:45 ET
Table '2367584539 20' 9-max Seat #3 is the button
Seat 1: victor_tda (1031 in chips) is sitting out
Seat 2: KimmieQQ (6249 in chips) 
Seat 3: hzane (11954 in chips) 
Seat 4: Mr. Amarelex (4885 in chips) 
Seat 5: roywjr (4688 in chips) 
Seat 6: pocketstuff (1196 in chips) 
Seat 7: hugo133813 (1213 in chips) 
Seat 9: poony53 (4609 in chips) 
victor_tda: posts the ante 12
KimmieQQ: posts the ante 12
hzane: posts the ante 12
Mr. Amarelex: posts the ante 12
roywjr: posts the ante 12
pocketstuff: posts the ante 12
hugo133813: posts the ante 12
poony53: posts the ante 12
Mr. Amarelex: posts small blind 60
roywjr: posts big blind 120
*** HOLE CARDS ***
Dealt to hzane [8c Js]
pocketstuff: folds 
hugo133813 is disconnected 
hugo133813 has timed out while disconnected
hugo133813: folds 
poony53: calls 120
victor_tda: folds 
KimmieQQ: calls 120
hzane: calls 120
Mr. Amarelex: calls 60
roywjr: checks 
*** FLOP *** [Th 2s 9s]
Mr. Amarelex: checks 
roywjr: checks 
poony53: checks 
KimmieQQ: checks 
hzane: bets 240
Mr. Amarelex: folds 
roywjr: folds 
poony53: calls 240
KimmieQQ: folds 
*** TURN *** [Th 2s 9s] [6c]
poony53: checks 
hzane: bets 360
poony53: folds 
Uncalled bet (360) returned to hzane
hzane collected 1176 from pot
*** SUMMARY ***
Total pot 1176 | Rake 0 
Board [Th 2s 9s 6c]
Seat 1: victor_tda folded before Flop (didn't bet)
Seat 2: KimmieQQ folded on the Flop
Seat 3: hzane (button) collected (1176)
Seat 4: Mr. Amarelex (small blind) folded on the Flop
Seat 5: roywjr (big blind) folded on the Flop
Seat 6: pocketstuff folded before Flop (didn't bet)
Seat 7: hugo133813 folded before Flop (didn't bet)
Seat 9: poony53 folded on the Turn



PokerStars Hand #189421749671: Tournament #2367584539, 9000+1000 Hold'em No Limit - Level XI (60/120) - 2018/08/01 21:47:14 ET
Table '2367584539 20' 9-max Seat #4 is the button
Seat 1: victor_tda (1019 in chips) is sitting out
Seat 2: KimmieQQ (6117 in chips) 
Seat 3: hzane (12758 in chips) 
Seat 4: Mr. Amarelex (4753 in chips) 
Seat 5: roywjr (4556 in chips) 
Seat 6: pocketstuff (1184 in chips) 
Seat 7: hugo133813 (1201 in chips) 
Seat 8: RACING339 (5067 in chips) 
Seat 9: poony53 (4237 in chips) 
victor_tda: posts the ante 12
KimmieQQ: posts the ante 12
hzane: posts the ante 12
Mr. Amarelex: posts the ante 12
roywjr: posts the ante 12
pocketstuff: posts the ante 12
hugo133813: posts the ante 12
RACING339: posts the ante 12
poony53: posts the ante 12
roywjr: posts small blind 60
pocketstuff: posts big blind 120
*** HOLE CARDS ***
Dealt to hzane [7d 6h]
hugo133813: calls 120
RACING339: calls 120
poony53: calls 120
victor_tda: folds 
KimmieQQ: folds 
hzane: folds 
Mr. Amarelex: folds 
roywjr: folds 
pocketstuff: checks 
*** FLOP *** [8s 4d 5h]
pocketstuff: checks 
hugo133813: checks 
RACING339: bets 324
poony53: folds 
pocketstuff: folds 
hugo133813: folds 
Uncalled bet (324) returned to RACING339
RACING339 collected 648 from pot
*** SUMMARY ***
Total pot 648 | Rake 0 
Board [8s 4d 5h]
Seat 1: victor_tda folded before Flop (didn't bet)
Seat 2: KimmieQQ folded before Flop (didn't bet)
Seat 3: hzane folded before Flop (didn't bet)
Seat 4: Mr. Amarelex (button) folded before Flop (didn't bet)
Seat 5: roywjr (small blind) folded before Flop
Seat 6: pocketstuff (big blind) folded on the Flop
Seat 7: hugo133813 folded on the Flop
Seat 8: RACING339 collected (648)
Seat 9: poony53 folded on the Flop



PokerStars Hand #189421759491: Tournament #2367584539, 9000+1000 Hold'em No Limit - Level XI (60/120) - 2018/08/01 21:47:44 ET
Table '2367584539 20' 9-max Seat #5 is the button
Seat 1: victor_tda (1007 in chips) is sitting out
Seat 2: KimmieQQ (6105 in chips) 
Seat 3: hzane (12746 in chips) 
Seat 4: Mr. Amarelex (4741 in chips) 
Seat 5: roywjr (4484 in chips) 
Seat 6: pocketstuff (1052 in chips) 
Seat 7: hugo133813 (1069 in chips) 
Seat 8: RACING339 (5583 in chips) 
Seat 9: poony53 (4105 in chips) 
victor_tda: posts the ante 12
KimmieQQ: posts the ante 12
hzane: posts the ante 12
Mr. Amarelex: posts the ante 12
roywjr: posts the ante 12
pocketstuff: posts the ante 12
hugo133813: posts the ante 12
RACING339: posts the ante 12
poony53: posts the ante 12
pocketstuff: posts small blind 60
hugo133813: posts big blind 120
*** HOLE CARDS ***
Dealt to hzane [4s Qs]
RACING339: raises 360 to 480
poony53: folds 
victor_tda: folds 
KimmieQQ: folds 
hzane: folds 
Mr. Amarelex: calls 480
roywjr: folds 
pocketstuff: folds 
hugo133813: folds 
*** FLOP *** [5s 6d 8h]
RACING339: bets 360
Mr. Amarelex: raises 3889 to 4249 and is all-in
RACING339: folds [Ts]
Uncalled bet (3889) returned to Mr. Amarelex
Mr. Amarelex collected 1968 from pot
Mr. Amarelex: doesn't show hand 
*** SUMMARY ***
Total pot 1968 | Rake 0 
Board [5s 6d 8h]
Seat 1: victor_tda folded before Flop (didn't bet)
Seat 2: KimmieQQ folded before Flop (didn't bet)
Seat 3: hzane folded before Flop (didn't bet)
Seat 4: Mr. Amarelex collected (1968)
Seat 5: roywjr (button) folded before Flop (didn't bet)
Seat 6: pocketstuff (small blind) folded before Flop
Seat 7: hugo133813 (big blind) folded before Flop
Seat 8: RACING339 folded on the Flop
Seat 9: poony53 folded before Flop (didn't bet)



PokerStars Hand #189421774316: Tournament #2367584539, 9000+1000 Hold'em No Limit - Level XII (70/140) - 2018/08/01 21:48:28 ET
Table '2367584539 20' 9-max Seat #6 is the button
Seat 1: victor_tda (995 in chips) is sitting out
Seat 2: KimmieQQ (6093 in chips) 
Seat 3: hzane (12734 in chips) is sitting out
Seat 4: Mr. Amarelex (5857 in chips) 
Seat 5: roywjr (4472 in chips) 
Seat 6: pocketstuff (980 in chips) 
Seat 7: hugo133813 (937 in chips) 
Seat 8: RACING339 (4731 in chips) 
Seat 9: poony53 (4093 in chips) 
victor_tda: posts the ante 14
KimmieQQ: posts the ante 14
hzane: posts the ante 14
Mr. Amarelex: posts the ante 14
roywjr: posts the ante 14
pocketstuff: posts the ante 14
hugo133813: posts the ante 14
RACING339: posts the ante 14
poony53: posts the ante 14
hugo133813: posts small blind 70
RACING339: posts big blind 140
*** HOLE CARDS ***
Dealt to hzane [Qs 5c]
poony53: folds 
victor_tda: folds 
KimmieQQ: calls 140
hzane: folds 
Mr. Amarelex: calls 140
roywjr: calls 140
pocketstuff: raises 826 to 966 and is all-in
hugo133813: folds 
RACING339: folds 
KimmieQQ: calls 826
Mr. Amarelex: folds 
roywjr: folds 
*** FLOP *** [4c 7d 7c]
*** TURN *** [4c 7d 7c] [2d]
*** RIVER *** [4c 7d 7c 2d] [3s]
*** SHOW DOWN ***
KimmieQQ: shows [Th Qd] (a pair of Sevens)
pocketstuff: shows [As Jh] (a pair of Sevens - Ace kicker)
pocketstuff collected 2548 from pot
*** SUMMARY ***
Total pot 2548 | Rake 0 
Board [4c 7d 7c 2d 3s]
Seat 1: victor_tda folded before Flop (didn't bet)
Seat 2: KimmieQQ showed [Th Qd] and lost with a pair of Sevens
Seat 3: hzane folded before Flop (didn't bet)
Seat 4: Mr. Amarelex folded before Flop
Seat 5: roywjr folded before Flop
Seat 6: pocketstuff (button) showed [As Jh] and won (2548) with a pair of Sevens
Seat 7: hugo133813 (small blind) folded before Flop
Seat 8: RACING339 (big blind) folded before Flop
Seat 9: poony53 folded before Flop (didn't bet)



PokerStars Hand #189421791062: Tournament #2367584539, 9000+1000 Hold'em No Limit - Level XII (70/140) - 2018/08/01 21:49:19 ET
Table '2367584539 20' 9-max Seat #7 is the button
Seat 1: victor_tda (981 in chips) 
Seat 2: KimmieQQ (5113 in chips) 
Seat 3: hzane (12720 in chips) is sitting out
Seat 4: Mr. Amarelex (5703 in chips) 
Seat 5: roywjr (4318 in chips) 
Seat 6: pocketstuff (2548 in chips) 
Seat 7: hugo133813 (853 in chips) 
Seat 8: RACING339 (4577 in chips) 
Seat 9: poony53 (4079 in chips) 
victor_tda: posts the ante 14
KimmieQQ: posts the ante 14
hzane: posts the ante 14
Mr. Amarelex: posts the ante 14
roywjr: posts the ante 14
pocketstuff: posts the ante 14
hugo133813: posts the ante 14
RACING339: posts the ante 14
poony53: posts the ante 14
RACING339: posts small blind 70
poony53: posts big blind 140
*** HOLE CARDS ***
Dealt to hzane [Qd 2c]
victor_tda: folds 
KimmieQQ: folds 
hzane: folds 
Mr. Amarelex: calls 140
roywjr: folds 
pocketstuff: folds 
hugo133813: calls 140
RACING339: raises 686 to 826
poony53: folds 
Mr. Amarelex: calls 686
hugo133813: calls 686
*** FLOP *** [7h 4c 2d]
RACING339: bets 840
Mr. Amarelex: calls 840
hugo133813 is disconnected 
hugo133813 is connected 
hugo133813: folds 
*** TURN *** [7h 4c 2d] [4s]
RACING339: bets 2897 and is all-in
Mr. Amarelex: calls 2897
*** RIVER *** [7h 4c 2d 4s] [Qh]
*** SHOW DOWN ***
RACING339: shows [Qc Qs] (a full house, Queens full of Fours)
Mr. Amarelex: shows [Ad 3c] (a pair of Fours)
RACING339 collected 10218 from pot
*** SUMMARY ***
Total pot 10218 | Rake 0 
Board [7h 4c 2d 4s Qh]
Seat 1: victor_tda folded before Flop (didn't bet)
Seat 2: KimmieQQ folded before Flop (didn't bet)
Seat 3: hzane folded before Flop (didn't bet)
Seat 4: Mr. Amarelex showed [Ad 3c] and lost with a pair of Fours
Seat 5: roywjr folded before Flop (didn't bet)
Seat 6: pocketstuff folded before Flop (didn't bet)
Seat 7: hugo133813 (button) folded on the Flop
Seat 8: RACING339 (small blind) showed [Qc Qs] and won (10218) with a full house, Queens full of Fours
Seat 9: poony53 (big blind) folded before Flop



PokerStars Hand #189421823115: Tournament #2367584539, 9000+1000 Hold'em No Limit - Level XII (70/140) - 2018/08/01 21:50:43 ET
Table '2367584539 20' 9-max Seat #8 is the button
Seat 1: victor_tda (967 in chips) 
Seat 2: KimmieQQ (5099 in chips) 
Seat 3: hzane (12706 in chips) is sitting out
Seat 4: Mr. Amarelex (1126 in chips) 
Seat 5: roywjr (4304 in chips) 
Seat 6: pocketstuff (2534 in chips) 
Seat 7: hugo133813 (13 in chips) 
Seat 8: RACING339 (10218 in chips) 
Seat 9: poony53 (3925 in chips) 
victor_tda: posts the ante 14
KimmieQQ: posts the ante 14
hzane: posts the ante 14
Mr. Amarelex: posts the ante 14
roywjr: posts the ante 14
pocketstuff: posts the ante 14
hugo133813: posts the ante 13 and is all-in
RACING339: posts the ante 14
poony53: posts the ante 14
poony53: posts small blind 70
victor_tda: posts big blind 140
*** HOLE CARDS ***
Dealt to hzane [Kh Th]
KimmieQQ: calls 140
hzane: folds 
Mr. Amarelex: folds 
roywjr: calls 140
pocketstuff: folds 
RACING339: calls 140
poony53: folds 
victor_tda: checks 
*** FLOP *** [6h 6s 7c]
victor_tda: checks 
KimmieQQ: checks 
roywjr: checks 
RACING339: checks 
*** TURN *** [6h 6s 7c] [9h]
victor_tda: checks 
KimmieQQ: bets 140
roywjr: folds 
RACING339: folds 
victor_tda: calls 140
*** RIVER *** [6h 6s 7c 9h] [4h]
victor_tda: checks 
KimmieQQ: checks 
*** SHOW DOWN ***
victor_tda: shows [5d 3c] (a straight, Three to Seven)
KimmieQQ: mucks hand 
victor_tda collected 918 from side pot
hugo133813: mucks hand 
victor_tda collected 117 from main pot
hugo133813 finished the tournament in 174th place
*** SUMMARY ***
Total pot 1035 Main pot 117. Side pot 918. | Rake 0 
Board [6h 6s 7c 9h 4h]
Seat 1: victor_tda (big blind) showed [5d 3c] and won (1035) with a straight, Three to Seven
Seat 2: KimmieQQ mucked [Jd 7d]
Seat 3: hzane folded before Flop (didn't bet)
Seat 4: Mr. Amarelex folded before Flop (didn't bet)
Seat 5: roywjr folded on the Turn
Seat 6: pocketstuff folded before Flop (didn't bet)
Seat 7: hugo133813 mucked [As Qc]
Seat 8: RACING339 (button) folded on the Turn
Seat 9: poony53 (small blind) folded before Flop



PokerStars Hand #189421843847: Tournament #2367584539, 9000+1000 Hold'em No Limit - Level XIII (80/160) - 2018/08/01 21:51:46 ET
Table '2367584539 20' 9-max Seat #9 is the button
Seat 1: victor_tda (1708 in chips) 
Seat 2: KimmieQQ (4805 in chips) 
Seat 3: hzane (12692 in chips) is sitting out
Seat 4: Mr. Amarelex (1112 in chips) 
Seat 5: roywjr (4150 in chips) 
Seat 6: pocketstuff (2520 in chips) 
Seat 8: RACING339 (10064 in chips) 
Seat 9: poony53 (3841 in chips) 
victor_tda: posts the ante 16
KimmieQQ: posts the ante 16
hzane: posts the ante 16
Mr. Amarelex: posts the ante 16
roywjr: posts the ante 16
pocketstuff: posts the ante 16
RACING339: posts the ante 16
poony53: posts the ante 16
victor_tda: posts small blind 80
KimmieQQ: posts big blind 160
*** HOLE CARDS ***
Dealt to hzane [5d 4c]
hzane: folds 
Mr. Amarelex: folds 
roywjr: calls 160
pocketstuff: folds 
RACING339: calls 160
poony53: folds 
victor_tda: calls 80
KimmieQQ: checks 
*** FLOP *** [9c 2s As]
victor_tda: checks 
KimmieQQ: checks 
roywjr: checks 
RACING339: checks 
*** TURN *** [9c 2s As] [3h]
victor_tda: checks 
KimmieQQ: checks 
roywjr: checks 
RACING339: checks 
*** RIVER *** [9c 2s As 3h] [Td]
victor_tda: bets 320
KimmieQQ: folds 
roywjr: folds 
RACING339: folds 
Uncalled bet (320) returned to victor_tda
victor_tda collected 768 from pot
victor_tda: doesn't show hand 
*** SUMMARY ***
Total pot 768 | Rake 0 
Board [9c 2s As 3h Td]
Seat 1: victor_tda (small blind) collected (768)
Seat 2: KimmieQQ (big blind) folded on the River
Seat 3: hzane folded before Flop (didn't bet)
Seat 4: Mr. Amarelex folded before Flop (didn't bet)
Seat 5: roywjr folded on the River
Seat 6: pocketstuff folded before Flop (didn't bet)
Seat 8: RACING339 folded on the River
Seat 9: poony53 (button) folded before Flop (didn't bet)



PokerStars Hand #189421867135: Tournament #2367584539, 9000+1000 Hold'em No Limit - Level XIII (80/160) - 2018/08/01 21:52:56 ET
Table '2367584539 20' 9-max Seat #1 is the button
Seat 1: victor_tda (2300 in chips) 
Seat 2: KimmieQQ (4629 in chips) 
Seat 3: hzane (12676 in chips) is sitting out
Seat 4: Mr. Amarelex (1096 in chips) 
Seat 5: roywjr (3974 in chips) 
Seat 6: pocketstuff (2504 in chips) 
Seat 7: miric11 (6010 in chips) 
Seat 8: RACING339 (9888 in chips) 
Seat 9: poony53 (3825 in chips) 
victor_tda: posts the ante 16
KimmieQQ: posts the ante 16
hzane: posts the ante 16
Mr. Amarelex: posts the ante 16
roywjr: posts the ante 16
pocketstuff: posts the ante 16
miric11: posts the ante 16
RACING339: posts the ante 16
poony53: posts the ante 16
KimmieQQ: posts small blind 80
hzane: posts big blind 160
*** HOLE CARDS ***
Dealt to hzane [As Jh]
Mr. Amarelex: folds 
roywjr: folds 
pocketstuff: calls 160
miric11: calls 160
RACING339: calls 160
poony53: folds 
victor_tda: calls 160
KimmieQQ: folds 
hzane: folds 
*** FLOP *** [2h Qd Jd]
pocketstuff: checks 
miric11: checks 
RACING339: checks 
victor_tda: checks 
*** TURN *** [2h Qd Jd] [8d]
pocketstuff: bets 160
miric11: calls 160
RACING339: raises 160 to 320
victor_tda: folds 
pocketstuff: raises 160 to 480
miric11: folds 
RACING339: calls 160
*** RIVER *** [2h Qd Jd 8d] [8c]
pocketstuff: bets 960
RACING339: raises 8272 to 9232 and is all-in
pocketstuff: calls 888 and is all-in
Uncalled bet (7384) returned to RACING339
*** SHOW DOWN ***
RACING339: shows [Td 9h] (a straight, Eight to Queen)
pocketstuff: shows [Ad 4d] (a flush, Ace high)
pocketstuff collected 5840 from pot
*** SUMMARY ***
Total pot 5840 | Rake 0 
Board [2h Qd Jd 8d 8c]
Seat 1: victor_tda (button) folded on the Turn
Seat 2: KimmieQQ (small blind) folded before Flop
Seat 3: hzane (big blind) folded before Flop
Seat 4: Mr. Amarelex folded before Flop (didn't bet)
Seat 5: roywjr folded before Flop (didn't bet)
Seat 6: pocketstuff showed [Ad 4d] and won (5840) with a flush, Ace high
Seat 7: miric11 folded on the Turn
Seat 8: RACING339 showed [Td 9h] and lost with a straight, Eight to Queen
Seat 9: poony53 folded before Flop (didn't bet)



PokerStars Hand #189421895334: Tournament #2367584539, 9000+1000 Hold'em No Limit - Level XIV (100/200) - 2018/08/01 21:54:21 ET
Table '2367584539 20' 9-max Seat #2 is the button
Seat 1: victor_tda (2124 in chips) 
Seat 2: KimmieQQ (4533 in chips) 
Seat 3: hzane (12500 in chips) is sitting out
Seat 4: Mr. Amarelex (1080 in chips) 
Seat 5: roywjr (3958 in chips) 
Seat 6: pocketstuff (5840 in chips) 
Seat 7: miric11 (5674 in chips) 
Seat 8: RACING339 (7384 in chips) 
Seat 9: poony53 (3809 in chips) 
victor_tda: posts the ante 20
KimmieQQ: posts the ante 20
hzane: posts the ante 20
Mr. Amarelex: posts the ante 20
roywjr: posts the ante 20
pocketstuff: posts the ante 20
miric11: posts the ante 20
RACING339: posts the ante 20
poony53: posts the ante 20
hzane: posts small blind 100
Mr. Amarelex: posts big blind 200
*** HOLE CARDS ***
Dealt to hzane [5c 4s]
roywjr: folds 
pocketstuff: calls 200
miric11: calls 200
RACING339: folds 
poony53: folds 
victor_tda: calls 200
KimmieQQ: folds 
hzane: folds 
Mr. Amarelex: raises 860 to 1060 and is all-in
pocketstuff: folds 
miric11: folds 
victor_tda: folds 
Uncalled bet (860) returned to Mr. Amarelex
Mr. Amarelex collected 1080 from pot
Mr. Amarelex: doesn't show hand 
*** SUMMARY ***
Total pot 1080 | Rake 0 
Seat 1: victor_tda folded before Flop
Seat 2: KimmieQQ (button) folded before Flop (didn't bet)
Seat 3: hzane (small blind) folded before Flop
Seat 4: Mr. Amarelex (big blind) collected (1080)
Seat 5: roywjr folded before Flop (didn't bet)
Seat 6: pocketstuff folded before Flop
Seat 7: miric11 folded before Flop
Seat 8: RACING339 folded before Flop (didn't bet)
Seat 9: poony53 folded before Flop (didn't bet)



PokerStars Hand #189421906376: Tournament #2367584539, 9000+1000 Hold'em No Limit - Level XIV (100/200) - 2018/08/01 21:54:55 ET
Table '2367584539 20' 9-max Seat #3 is the button
Seat 1: victor_tda (1904 in chips) 
Seat 2: KimmieQQ (4513 in chips) 
Seat 3: hzane (12380 in chips) is sitting out
Seat 4: Mr. Amarelex (1940 in chips) 
Seat 5: roywjr (3938 in chips) 
Seat 6: pocketstuff (5620 in chips) 
Seat 7: miric11 (5454 in chips) 
Seat 8: RACING339 (7364 in chips) 
Seat 9: poony53 (3789 in chips) 
victor_tda: posts the ante 20
KimmieQQ: posts the ante 20
hzane: posts the ante 20
Mr. Amarelex: posts the ante 20
roywjr: posts the ante 20
pocketstuff: posts the ante 20
miric11: posts the ante 20
RACING339: posts the ante 20
poony53: posts the ante 20
Mr. Amarelex: posts small blind 100
roywjr: posts big blind 200
*** HOLE CARDS ***
Dealt to hzane [Js 4d]
pocketstuff: calls 200
miric11: calls 200
RACING339: folds 
poony53: folds 
victor_tda: calls 200
KimmieQQ: calls 200
hzane: folds 
Mr. Amarelex: folds 
roywjr: checks 
*** FLOP *** [Ad 2s 3c]
roywjr: checks 
pocketstuff: bets 200
miric11: calls 200
victor_tda: folds 
KimmieQQ: calls 200
roywjr: folds 
*** TURN *** [Ad 2s 3c] [2c]
pocketstuff: bets 200
miric11: calls 200
KimmieQQ: calls 200
*** RIVER *** [Ad 2s 3c 2c] [8c]
pocketstuff: bets 600
miric11: calls 600
KimmieQQ: folds 
*** SHOW DOWN ***
pocketstuff: shows [Ac Qc] (a flush, Ace high)
miric11: mucks hand 
pocketstuff collected 3680 from pot
*** SUMMARY ***
Total pot 3680 | Rake 0 
Board [Ad 2s 3c 2c 8c]
Seat 1: victor_tda folded on the Flop
Seat 2: KimmieQQ folded on the River
Seat 3: hzane (button) folded before Flop (didn't bet)
Seat 4: Mr. Amarelex (small blind) folded before Flop
Seat 5: roywjr (big blind) folded on the Flop
Seat 6: pocketstuff showed [Ac Qc] and won (3680) with a flush, Ace high
Seat 7: miric11 mucked [4c 7c]
Seat 8: RACING339 folded before Flop (didn't bet)
Seat 9: poony53 folded before Flop (didn't bet)



PokerStars Hand #189422011260: Tournament #2367584539, 9000+1000 Hold'em No Limit - Level XIV (100/200) - 2018/08/01 22:01:13 ET
Table '2367584539 20' 9-max Seat #4 is the button
Seat 1: victor_tda (1684 in chips) 
Seat 2: KimmieQQ (3893 in chips) 
Seat 3: hzane (12360 in chips) 
Seat 4: Mr. Amarelex (1820 in chips) 
Seat 5: roywjr (3718 in chips) 
Seat 6: pocketstuff (8080 in chips) 
Seat 7: miric11 (4234 in chips) 
Seat 8: RACING339 (7344 in chips) 
Seat 9: poony53 (3769 in chips) 
victor_tda: posts the ante 20
KimmieQQ: posts the ante 20
hzane: posts the ante 20
Mr. Amarelex: posts the ante 20
roywjr: posts the ante 20
pocketstuff: posts the ante 20
miric11: posts the ante 20
RACING339: posts the ante 20
poony53: posts the ante 20
roywjr: posts small blind 100
pocketstuff: posts big blind 200
*** HOLE CARDS ***
Dealt to hzane [Jh Jd]
miric11: folds 
RACING339: calls 200
poony53: folds 
victor_tda: folds 
KimmieQQ: calls 200
hzane: raises 600 to 800
Mr. Amarelex: raises 1000 to 1800 and is all-in
roywjr: folds 
pocketstuff: folds 
RACING339: folds 
KimmieQQ: calls 1600
hzane: raises 10540 to 12340 and is all-in
KimmieQQ: calls 2073 and is all-in
Uncalled bet (8467) returned to hzane
*** FLOP *** [2h 7c 3s]
*** TURN *** [2h 7c 3s] [Qd]
*** RIVER *** [2h 7c 3s Qd] [4s]
*** SHOW DOWN ***
KimmieQQ: shows [7h As] (a pair of Sevens)
hzane: shows [Jh Jd] (a pair of Jacks)
hzane collected 4146 from side pot
Mr. Amarelex: shows [Td Qc] (a pair of Queens)
Mr. Amarelex collected 6080 from main pot
KimmieQQ finished the tournament in 143rd place
*** SUMMARY ***
Total pot 10226 Main pot 6080. Side pot 4146. | Rake 0 
Board [2h 7c 3s Qd 4s]
Seat 1: victor_tda folded before Flop (didn't bet)
Seat 2: KimmieQQ showed [7h As] and lost with a pair of Sevens
Seat 3: hzane showed [Jh Jd] and won (4146) with a pair of Jacks
Seat 4: Mr. Amarelex (button) showed [Td Qc] and won (6080) with a pair of Queens
Seat 5: roywjr (small blind) folded before Flop
Seat 6: pocketstuff (big blind) folded before Flop
Seat 7: miric11 folded before Flop (didn't bet)
Seat 8: RACING339 folded before Flop
Seat 9: poony53 folded before Flop (didn't bet)



PokerStars Hand #189422034672: Tournament #2367584539, 9000+1000 Hold'em No Limit - Level XIV (100/200) - 2018/08/01 22:02:27 ET
Table '2367584539 20' 9-max Seat #5 is the button
Seat 1: victor_tda (1664 in chips) is sitting out
Seat 3: hzane (12613 in chips) 
Seat 4: Mr. Amarelex (6080 in chips) 
Seat 5: roywjr (3598 in chips) 
Seat 6: pocketstuff (7860 in chips) 
Seat 7: miric11 (4214 in chips) 
Seat 8: RACING339 (7124 in chips) 
Seat 9: poony53 (3749 in chips) 
victor_tda: posts the ante 20
hzane: posts the ante 20
Mr. Amarelex: posts the ante 20
roywjr: posts the ante 20
pocketstuff: posts the ante 20
miric11: posts the ante 20
RACING339: posts the ante 20
poony53: posts the ante 20
pocketstuff: posts small blind 100
miric11: posts big blind 200
*** HOLE CARDS ***
Dealt to hzane [6s Qd]
RACING339: raises 660 to 860
poony53: folds 
victor_tda: folds 
hzane: folds 
Mr. Amarelex: folds 
roywjr: folds 
pocketstuff: folds 
miric11: folds 
Uncalled bet (660) returned to RACING339
RACING339 collected 660 from pot
*** SUMMARY ***
Total pot 660 | Rake 0 
Seat 1: victor_tda folded before Flop (didn't bet)
Seat 3: hzane folded before Flop (didn't bet)
Seat 4: Mr. Amarelex folded before Flop (didn't bet)
Seat 5: roywjr (button) folded before Flop (didn't bet)
Seat 6: pocketstuff (small blind) folded before Flop
Seat 7: miric11 (big blind) folded before Flop
Seat 8: RACING339 collected (660)
Seat 9: poony53 folded before Flop (didn't bet)



PokerStars Hand #189422042693: Tournament #2367584539, 9000+1000 Hold'em No Limit - Level XIV (100/200) - 2018/08/01 22:02:52 ET
Table '2367584539 20' 9-max Seat #6 is the button
Seat 1: victor_tda (1644 in chips) is sitting out
Seat 3: hzane (12593 in chips) 
Seat 4: Mr. Amarelex (6060 in chips) 
Seat 5: roywjr (3578 in chips) 
Seat 6: pocketstuff (7740 in chips) 
Seat 7: miric11 (3994 in chips) 
Seat 8: RACING339 (7564 in chips) 
Seat 9: poony53 (3729 in chips) 
victor_tda: posts the ante 20
hzane: posts the ante 20
Mr. Amarelex: posts the ante 20
roywjr: posts the ante 20
pocketstuff: posts the ante 20
miric11: posts the ante 20
RACING339: posts the ante 20
poony53: posts the ante 20
miric11: posts small blind 100
RACING339: posts big blind 200
*** HOLE CARDS ***
Dealt to hzane [Ad 3s]
poony53: folds 
victor_tda: folds 
hzane: calls 200
Mr. Amarelex: calls 200
roywjr: folds 
pocketstuff: folds 
miric11: calls 100
RACING339: checks 
*** FLOP *** [Jh 4h 7d]
miric11: checks 
RACING339: checks 
hzane: bets 200
Mr. Amarelex: calls 200
miric11: folds 
RACING339: folds 
*** TURN *** [Jh 4h 7d] [8h]
hzane: checks 
Mr. Amarelex: checks 
*** RIVER *** [Jh 4h 7d 8h] [Td]
hzane: bets 600
Mr. Amarelex: calls 600
*** SHOW DOWN ***
hzane: shows [Ad 3s] (high card Ace)
Mr. Amarelex: shows [4d Ah] (a pair of Fours)
Mr. Amarelex collected 2560 from pot
*** SUMMARY ***
Total pot 2560 | Rake 0 
Board [Jh 4h 7d 8h Td]
Seat 1: victor_tda folded before Flop (didn't bet)
Seat 3: hzane showed [Ad 3s] and lost with high card Ace
Seat 4: Mr. Amarelex showed [4d Ah] and won (2560) with a pair of Fours
Seat 5: roywjr folded before Flop (didn't bet)
Seat 6: pocketstuff (button) folded before Flop (didn't bet)
Seat 7: miric11 (small blind) folded on the Flop
Seat 8: RACING339 (big blind) folded on the Flop
Seat 9: poony53 folded before Flop (didn't bet)



PokerStars Hand #189422064157: Tournament #2367584539, 9000+1000 Hold'em No Limit - Level XV (120/240) - 2018/08/01 22:03:59 ET
Table '2367584539 20' 9-max Seat #7 is the button
Seat 1: victor_tda (1624 in chips) is sitting out
Seat 2: tins (14084 in chips) 
Seat 3: hzane (11573 in chips) 
Seat 4: Mr. Amarelex (7600 in chips) 
Seat 5: roywjr (3558 in chips) 
Seat 6: pocketstuff (7720 in chips) 
Seat 7: miric11 (3774 in chips) 
Seat 8: RACING339 (7344 in chips) 
Seat 9: poony53 (3709 in chips) 
victor_tda: posts the ante 24
tins: posts the ante 24
hzane: posts the ante 24
Mr. Amarelex: posts the ante 24
roywjr: posts the ante 24
pocketstuff: posts the ante 24
miric11: posts the ante 24
RACING339: posts the ante 24
poony53: posts the ante 24
RACING339: posts small blind 120
poony53: posts big blind 240
*** HOLE CARDS ***
Dealt to hzane [5h 2h]
victor_tda: folds 
tins: folds 
hzane: calls 240
Mr. Amarelex: calls 240
roywjr: folds 
pocketstuff: calls 240
miric11: raises 3510 to 3750 and is all-in
RACING339: folds 
poony53: folds 
hzane: folds 
Mr. Amarelex: folds 
pocketstuff: folds 
Uncalled bet (3510) returned to miric11
miric11 collected 1536 from pot
*** SUMMARY ***
Total pot 1536 | Rake 0 
Seat 1: victor_tda folded before Flop (didn't bet)
Seat 2: tins folded before Flop (didn't bet)
Seat 3: hzane folded before Flop
Seat 4: Mr. Amarelex folded before Flop
Seat 5: roywjr folded before Flop (didn't bet)
Seat 6: pocketstuff folded before Flop
Seat 7: miric11 (button) collected (1536)
Seat 8: RACING339 (small blind) folded before Flop
Seat 9: poony53 (big blind) folded before Flop



PokerStars Hand #189422075584: Tournament #2367584539, 9000+1000 Hold'em No Limit - Level XV (120/240) - 2018/08/01 22:04:35 ET
Table '2367584539 20' 9-max Seat #8 is the button
Seat 1: victor_tda (1600 in chips) 
Seat 2: tins (14060 in chips) 
Seat 3: hzane (11309 in chips) 
Seat 4: Mr. Amarelex (7336 in chips) 
Seat 5: roywjr (3534 in chips) 
Seat 6: pocketstuff (7456 in chips) 
Seat 7: miric11 (5046 in chips) 
Seat 8: RACING339 (7200 in chips) 
Seat 9: poony53 (3445 in chips) 
victor_tda: posts the ante 24
tins: posts the ante 24
hzane: posts the ante 24
Mr. Amarelex: posts the ante 24
roywjr: posts the ante 24
pocketstuff: posts the ante 24
miric11: posts the ante 24
RACING339: posts the ante 24
poony53: posts the ante 24
poony53: posts small blind 120
victor_tda: posts big blind 240
*** HOLE CARDS ***
Dealt to hzane [Td 9d]
tins: folds 
hzane: calls 240
Mr. Amarelex: folds 
roywjr: folds 
pocketstuff: folds 
miric11: folds 
RACING339: folds 
poony53: folds 
victor_tda: checks 
*** FLOP *** [Qc 8s 7d]
victor_tda: checks 
hzane: checks 
*** TURN *** [Qc 8s 7d] [5d]
victor_tda: checks 
hzane: bets 240
victor_tda: folds 
Uncalled bet (240) returned to hzane
hzane collected 816 from pot
*** SUMMARY ***
Total pot 816 | Rake 0 
Board [Qc 8s 7d 5d]
Seat 1: victor_tda (big blind) folded on the Turn
Seat 2: tins folded before Flop (didn't bet)
Seat 3: hzane collected (816)
Seat 4: Mr. Amarelex folded before Flop (didn't bet)
Seat 5: roywjr folded before Flop (didn't bet)
Seat 6: pocketstuff folded before Flop (didn't bet)
Seat 7: miric11 folded before Flop (didn't bet)
Seat 8: RACING339 (button) folded before Flop (didn't bet)
Seat 9: poony53 (small blind) folded before Flop



PokerStars Hand #189422088933: Tournament #2367584539, 9000+1000 Hold'em No Limit - Level XV (120/240) - 2018/08/01 22:05:16 ET
Table '2367584539 20' 9-max Seat #9 is the button
Seat 1: victor_tda (1336 in chips) 
Seat 2: tins (14036 in chips) 
Seat 3: hzane (11861 in chips) 
Seat 4: Mr. Amarelex (7312 in chips) 
Seat 5: roywjr (3510 in chips) 
Seat 6: pocketstuff (7432 in chips) 
Seat 7: miric11 (5022 in chips) 
Seat 8: RACING339 (7176 in chips) 
Seat 9: poony53 (3301 in chips) 
victor_tda: posts the ante 24
tins: posts the ante 24
hzane: posts the ante 24
Mr. Amarelex: posts the ante 24
roywjr: posts the ante 24
pocketstuff: posts the ante 24
miric11: posts the ante 24
RACING339: posts the ante 24
poony53: posts the ante 24
victor_tda: posts small blind 120
tins: posts big blind 240
*** HOLE CARDS ***
Dealt to hzane [4c Td]
hzane: folds 
Mr. Amarelex: calls 240
roywjr: folds 
pocketstuff: folds 
miric11: raises 4758 to 4998 and is all-in
RACING339: folds 
hzane is disconnected 
poony53: folds 
victor_tda: calls 1192 and is all-in
tins: folds 
Mr. Amarelex: folds 
Uncalled bet (3686) returned to miric11
*** FLOP *** [9d 3c 8c]
*** TURN *** [9d 3c 8c] [Qs]
*** RIVER *** [9d 3c 8c Qs] [5h]
*** SHOW DOWN ***
victor_tda: shows [Jh Js] (a pair of Jacks)
miric11: shows [Ks As] (high card Ace)
victor_tda collected 3320 from pot
*** SUMMARY ***
Total pot 3320 | Rake 0 
Board [9d 3c 8c Qs 5h]
Seat 1: victor_tda (small blind) showed [Jh Js] and won (3320) with a pair of Jacks
Seat 2: tins (big blind) folded before Flop
Seat 3: hzane folded before Flop (didn't bet)
Seat 4: Mr. Amarelex folded before Flop
Seat 5: roywjr folded before Flop (didn't bet)
Seat 6: pocketstuff folded before Flop (didn't bet)
Seat 7: miric11 showed [Ks As] and lost with high card Ace
Seat 8: RACING339 folded before Flop (didn't bet)
Seat 9: poony53 (button) folded before Flop (didn't bet)



PokerStars Hand #189422100475: Tournament #2367584539, 9000+1000 Hold'em No Limit - Level XV (120/240) - 2018/08/01 22:05:52 ET
Table '2367584539 20' 9-max Seat #1 is the button
Seat 1: victor_tda (3320 in chips) 
Seat 2: tins (13772 in chips) 
Seat 3: hzane (11837 in chips) 
Seat 4: Mr. Amarelex (7048 in chips) 
Seat 5: roywjr (3486 in chips) 
Seat 6: pocketstuff (7408 in chips) 
Seat 7: miric11 (3686 in chips) 
Seat 8: RACING339 (7152 in chips) 
Seat 9: poony53 (3277 in chips) 
victor_tda: posts the ante 24
tins: posts the ante 24
hzane: posts the ante 24
Mr. Amarelex: posts the ante 24
roywjr: posts the ante 24
pocketstuff: posts the ante 24
miric11: posts the ante 24
RACING339: posts the ante 24
poony53: posts the ante 24
tins: posts small blind 120
hzane: posts big blind 240
*** HOLE CARDS ***
Dealt to hzane [Kd 4d]
Mr. Amarelex: folds 
roywjr: folds 
pocketstuff: calls 240
miric11: calls 240
RACING339: raises 1296 to 1536
poony53: folds 
victor_tda: folds 
tins: folds 
hzane: folds 
pocketstuff: calls 1296
miric11: calls 1296
*** FLOP *** [9s Qs Jc]
pocketstuff: bets 5848 and is all-in
miric11: calls 2126 and is all-in
RACING339: folds 
Uncalled bet (3722) returned to pocketstuff
*** TURN *** [9s Qs Jc] [Ad]
*** RIVER *** [9s Qs Jc Ad] [5c]
*** SHOW DOWN ***
pocketstuff: shows [Kc Qh] (a pair of Queens)
miric11: shows [5s 2s] (a pair of Fives)
pocketstuff collected 9436 from pot
miric11 finished the tournament in 123rd place
*** SUMMARY ***
Total pot 9436 | Rake 0 
Board [9s Qs Jc Ad 5c]
Seat 1: victor_tda (button) folded before Flop (didn't bet)
Seat 2: tins (small blind) folded before Flop
Seat 3: hzane (big blind) folded before Flop
Seat 4: Mr. Amarelex folded before Flop (didn't bet)
Seat 5: roywjr folded before Flop (didn't bet)
Seat 6: pocketstuff showed [Kc Qh] and won (9436) with a pair of Queens
Seat 7: miric11 showed [5s 2s] and lost with a pair of Fives
Seat 8: RACING339 folded on the Flop
Seat 9: poony53 folded before Flop (didn't bet)



PokerStars Hand #189422124832: Tournament #2367584539, 9000+1000 Hold'em No Limit - Level XVI (140/280) - 2018/08/01 22:06:57 ET
Table '2367584539 20' 9-max Seat #2 is the button
Seat 1: victor_tda (3296 in chips) 
Seat 2: tins (13628 in chips) 
Seat 3: hzane (11573 in chips) 
Seat 4: Mr. Amarelex (7024 in chips) 
Seat 5: roywjr (3462 in chips) 
Seat 6: pocketstuff (13158 in chips) 
Seat 8: RACING339 (5592 in chips) 
Seat 9: poony53 (3253 in chips) 
victor_tda: posts the ante 28
tins: posts the ante 28
hzane: posts the ante 28
Mr. Amarelex: posts the ante 28
roywjr: posts the ante 28
pocketstuff: posts the ante 28
RACING339: posts the ante 28
poony53: posts the ante 28
hzane: posts small blind 140
Mr. Amarelex: posts big blind 280
*** HOLE CARDS ***
Dealt to hzane [4h 6h]
roywjr: folds 
pocketstuff: folds 
RACING339: raises 560 to 840
poony53: folds 
victor_tda: calls 840
tins: folds 
hzane: folds 
Mr. Amarelex: raises 1400 to 2240
RACING339: raises 3324 to 5564 and is all-in
victor_tda: folds 
Mr. Amarelex: calls 3324
*** FLOP *** [3h 6c Ts]
*** TURN *** [3h 6c Ts] [9s]
*** RIVER *** [3h 6c Ts 9s] [As]
*** SHOW DOWN ***
Mr. Amarelex: shows [Ah Ad] (three of a kind, Aces)
RACING339: shows [Jh Kd] (high card Ace)
Mr. Amarelex collected 12332 from pot
*** SUMMARY ***
Total pot 12332 | Rake 0 
Board [3h 6c Ts 9s As]
Seat 1: victor_tda folded before Flop
Seat 2: tins (button) folded before Flop (didn't bet)
Seat 3: hzane (small blind) folded before Flop
Seat 4: Mr. Amarelex (big blind) showed [Ah Ad] and won (12332) with three of a kind, Aces
Seat 5: roywjr folded before Flop (didn't bet)
Seat 6: pocketstuff folded before Flop (didn't bet)
Seat 8: RACING339 showed [Jh Kd] and lost with high card Ace
Seat 9: poony53 folded before Flop (didn't bet)



PokerStars Hand #189422151504: Tournament #2367584539, 9000+1000 Hold'em No Limit - Level XVI (140/280) - 2018/08/01 22:08:20 ET
Table '2367584539 20' 9-max Seat #3 is the button
Seat 1: victor_tda (2428 in chips) 
Seat 2: tins (13600 in chips) 
Seat 3: hzane (11405 in chips) 
Seat 4: Mr. Amarelex (13764 in chips) 
Seat 5: roywjr (3434 in chips) 
Seat 6: pocketstuff (13130 in chips) 
Seat 7: sassysoul (2384 in chips) 
Seat 8: AndréGuaraci (5650 in chips) 
Seat 9: poony53 (3225 in chips) 
victor_tda: posts the ante 28
tins: posts the ante 28
hzane: posts the ante 28
Mr. Amarelex: posts the ante 28
roywjr: posts the ante 28
pocketstuff: posts the ante 28
sassysoul: posts the ante 28
AndréGuaraci: posts the ante 28
poony53: posts the ante 28
Mr. Amarelex: posts small blind 140
roywjr: posts big blind 280
*** HOLE CARDS ***
Dealt to hzane [9d 6c]
pocketstuff: folds 
sassysoul: raises 280 to 560
AndréGuaraci: folds 
poony53: folds 
victor_tda: folds 
tins: folds 
hzane: folds 
Mr. Amarelex: folds 
roywjr: folds 
Uncalled bet (280) returned to sassysoul
sassysoul collected 952 from pot
sassysoul: doesn't show hand 
*** SUMMARY ***
Total pot 952 | Rake 0 
Seat 1: victor_tda folded before Flop (didn't bet)
Seat 2: tins folded before Flop (didn't bet)
Seat 3: hzane (button) folded before Flop (didn't bet)
Seat 4: Mr. Amarelex (small blind) folded before Flop
Seat 5: roywjr (big blind) folded before Flop
Seat 6: pocketstuff folded before Flop (didn't bet)
Seat 7: sassysoul collected (952)
Seat 8: AndréGuaraci folded before Flop (didn't bet)
Seat 9: poony53 folded before Flop (didn't bet)



PokerStars Hand #189422162332: Tournament #2367584539, 9000+1000 Hold'em No Limit - Level XVI (140/280) - 2018/08/01 22:08:55 ET
Table '2367584539 20' 9-max Seat #4 is the button
Seat 1: victor_tda (2400 in chips) 
Seat 2: tins (13572 in chips) 
Seat 3: hzane (11377 in chips) 
Seat 4: Mr. Amarelex (13596 in chips) 
Seat 5: roywjr (3126 in chips) 
Seat 6: pocketstuff (13102 in chips) 
Seat 7: sassysoul (3028 in chips) 
Seat 8: AndréGuaraci (5622 in chips) 
Seat 9: poony53 (3197 in chips) 
victor_tda: posts the ante 28
tins: posts the ante 28
hzane: posts the ante 28
Mr. Amarelex: posts the ante 28
roywjr: posts the ante 28
pocketstuff: posts the ante 28
sassysoul: posts the ante 28
AndréGuaraci: posts the ante 28
poony53: posts the ante 28
roywjr: posts small blind 140
pocketstuff: posts big blind 280
*** HOLE CARDS ***
Dealt to hzane [6h Jc]
sassysoul: calls 280
AndréGuaraci: folds 
poony53: calls 280
victor_tda: calls 280
tins: folds 
hzane: folds 
Mr. Amarelex: folds 
roywjr: calls 140
pocketstuff: checks 
*** FLOP *** [Kc Ts 9s]
roywjr: bets 280
pocketstuff: folds 
sassysoul: raises 1106 to 1386
poony53: raises 1503 to 2889 and is all-in
victor_tda: calls 2092 and is all-in
roywjr: folds 
sassysoul: calls 1334 and is all-in
Uncalled bet (169) returned to poony53
*** TURN *** [Kc Ts 9s] [9h]
*** RIVER *** [Kc Ts 9s 9h] [Ah]
*** SHOW DOWN ***
sassysoul: shows [Qd Kh] (two pair, Kings and Nines)
poony53: shows [Ks Tc] (two pair, Kings and Tens)
poony53 collected 1256 from side pot
victor_tda: shows [Js 5s] (a pair of Nines)
poony53 collected 8208 from main pot
sassysoul finished the tournament in 115th place and received 15000.
victor_tda finished the tournament in 116th place and received 15000.
*** SUMMARY ***
Total pot 9464 Main pot 8208. Side pot 1256. | Rake 0 
Board [Kc Ts 9s 9h Ah]
Seat 1: victor_tda showed [Js 5s] and lost with a pair of Nines
Seat 2: tins folded before Flop (didn't bet)
Seat 3: hzane folded before Flop (didn't bet)
Seat 4: Mr. Amarelex (button) folded before Flop (didn't bet)
Seat 5: roywjr (small blind) folded on the Flop
Seat 6: pocketstuff (big blind) folded on the Flop
Seat 7: sassysoul showed [Qd Kh] and lost with two pair, Kings and Nines
Seat 8: AndréGuaraci folded before Flop (didn't bet)
Seat 9: poony53 showed [Ks Tc] and won (9464) with two pair, Kings and Tens



PokerStars Hand #189422181469: Tournament #2367584539, 9000+1000 Hold'em No Limit - Level XVII (160/320) - 2018/08/01 22:09:55 ET
Table '2367584539 20' 9-max Seat #5 is the button
Seat 1: zocker131415 (6333 in chips) 
Seat 2: tins (13544 in chips) 
Seat 3: hzane (11349 in chips) 
Seat 4: Mr. Amarelex (13568 in chips) 
Seat 5: roywjr (2538 in chips) 
Seat 6: pocketstuff (12794 in chips) 
Seat 8: AndréGuaraci (5594 in chips) 
Seat 9: poony53 (9633 in chips) 
zocker131415: posts the ante 32
tins: posts the ante 32
hzane: posts the ante 32
Mr. Amarelex: posts the ante 32
roywjr: posts the ante 32
pocketstuff: posts the ante 32
AndréGuaraci: posts the ante 32
poony53: posts the ante 32
pocketstuff: posts small blind 160
AndréGuaraci: posts big blind 320
*** HOLE CARDS ***
Dealt to hzane [4h Qc]
poony53: folds 
zocker131415: folds 
tins: raises 640 to 960
hzane: folds 
Mr. Amarelex: folds 
roywjr: folds 
pocketstuff: raises 11802 to 12762 and is all-in
AndréGuaraci: folds 
tins: calls 11802
*** FLOP *** [7d Jh 8c]
*** TURN *** [7d Jh 8c] [As]
*** RIVER *** [7d Jh 8c As] [Ks]
*** SHOW DOWN ***
pocketstuff: shows [Js Jd] (three of a kind, Jacks)
tins: shows [Qd Kc] (a pair of Kings)
pocketstuff collected 26100 from pot
*** SUMMARY ***
Total pot 26100 | Rake 0 
Board [7d Jh 8c As Ks]
Seat 1: zocker131415 folded before Flop (didn't bet)
Seat 2: tins showed [Qd Kc] and lost with a pair of Kings
Seat 3: hzane folded before Flop (didn't bet)
Seat 4: Mr. Amarelex folded before Flop (didn't bet)
Seat 5: roywjr (button) folded before Flop (didn't bet)
Seat 6: pocketstuff (small blind) showed [Js Jd] and won (26100) with three of a kind, Jacks
Seat 8: AndréGuaraci (big blind) folded before Flop
Seat 9: poony53 folded before Flop (didn't bet)



PokerStars Hand #189422195914: Tournament #2367584539, 9000+1000 Hold'em No Limit - Level XVII (160/320) - 2018/08/01 22:10:40 ET
Table '2367584539 20' 9-max Seat #6 is the button
Seat 1: zocker131415 (6301 in chips) 
Seat 2: tins (750 in chips) 
Seat 3: hzane (11317 in chips) 
Seat 4: Mr. Amarelex (13536 in chips) 
Seat 5: roywjr (2506 in chips) 
Seat 6: pocketstuff (26100 in chips) 
Seat 8: AndréGuaraci (5242 in chips) 
Seat 9: poony53 (9601 in chips) 
zocker131415: posts the ante 32
tins: posts the ante 32
hzane: posts the ante 32
Mr. Amarelex: posts the ante 32
roywjr: posts the ante 32
pocketstuff: posts the ante 32
AndréGuaraci: posts the ante 32
poony53: posts the ante 32
AndréGuaraci: posts small blind 160
poony53: posts big blind 320
*** HOLE CARDS ***
Dealt to hzane [Td 2c]
zocker131415: folds 
tins: raises 320 to 640
hzane: folds 
Mr. Amarelex: folds 
roywjr: folds 
pocketstuff: folds 
AndréGuaraci: folds 
poony53: folds 
Uncalled bet (320) returned to tins
tins collected 1056 from pot
*** SUMMARY ***
Total pot 1056 | Rake 0 
Seat 1: zocker131415 folded before Flop (didn't bet)
Seat 2: tins collected (1056)
Seat 3: hzane folded before Flop (didn't bet)
Seat 4: Mr. Amarelex folded before Flop (didn't bet)
Seat 5: roywjr folded before Flop (didn't bet)
Seat 6: pocketstuff (button) folded before Flop (didn't bet)
Seat 8: AndréGuaraci (small blind) folded before Flop
Seat 9: poony53 (big blind) folded before Flop



PokerStars Hand #189422203480: Tournament #2367584539, 9000+1000 Hold'em No Limit - Level XVII (160/320) - 2018/08/01 22:11:04 ET
Table '2367584539 20' 9-max Seat #8 is the button
Seat 1: zocker131415 (6269 in chips) 
Seat 2: tins (1454 in chips) 
Seat 3: hzane (11285 in chips) 
Seat 4: Mr. Amarelex (13504 in chips) 
Seat 5: roywjr (2474 in chips) 
Seat 6: pocketstuff (26068 in chips) 
Seat 8: AndréGuaraci (5050 in chips) 
Seat 9: poony53 (9249 in chips) 
zocker131415: posts the ante 32
tins: posts the ante 32
hzane: posts the ante 32
Mr. Amarelex: posts the ante 32
roywjr: posts the ante 32
pocketstuff: posts the ante 32
AndréGuaraci: posts the ante 32
poony53: posts the ante 32
poony53: posts small blind 160
zocker131415: posts big blind 320
*** HOLE CARDS ***
Dealt to hzane [9h 8s]
tins: folds 
hzane: folds 
Mr. Amarelex: folds 
roywjr: folds 
pocketstuff: folds 
AndréGuaraci: folds 
poony53: folds 
Uncalled bet (160) returned to zocker131415
zocker131415 collected 576 from pot
zocker131415: doesn't show hand 
*** SUMMARY ***
Total pot 576 | Rake 0 
Seat 1: zocker131415 (big blind) collected (576)
Seat 2: tins folded before Flop (didn't bet)
Seat 3: hzane folded before Flop (didn't bet)
Seat 4: Mr. Amarelex folded before Flop (didn't bet)
Seat 5: roywjr folded before Flop (didn't bet)
Seat 6: pocketstuff folded before Flop (didn't bet)
Seat 8: AndréGuaraci (button) folded before Flop (didn't bet)
Seat 9: poony53 (small blind) folded before Flop



PokerStars Hand #189422208291: Tournament #2367584539, 9000+1000 Hold'em No Limit - Level XVII (160/320) - 2018/08/01 22:11:19 ET
Table '2367584539 20' 9-max Seat #9 is the button
Seat 1: zocker131415 (6653 in chips) 
Seat 2: tins (1422 in chips) 
Seat 3: hzane (11253 in chips) 
Seat 4: Mr. Amarelex (13472 in chips) 
Seat 5: roywjr (2442 in chips) 
Seat 6: pocketstuff (26036 in chips) 
Seat 7: capitao pt (5269 in chips) 
Seat 8: AndréGuaraci (5018 in chips) 
Seat 9: poony53 (9057 in chips) 
zocker131415: posts the ante 32
tins: posts the ante 32
hzane: posts the ante 32
Mr. Amarelex: posts the ante 32
roywjr: posts the ante 32
pocketstuff: posts the ante 32
capitao pt: posts the ante 32
AndréGuaraci: posts the ante 32
poony53: posts the ante 32
zocker131415: posts small blind 160
tins: posts big blind 320
*** HOLE CARDS ***
Dealt to hzane [5s Kh]
hzane: folds 
Mr. Amarelex: folds 
roywjr: folds 
pocketstuff: folds 
capitao pt: folds 
AndréGuaraci: folds 
poony53: folds 
zocker131415: folds 
Uncalled bet (160) returned to tins
tins collected 608 from pot
*** SUMMARY ***
Total pot 608 | Rake 0 
Seat 1: zocker131415 (small blind) folded before Flop
Seat 2: tins (big blind) collected (608)
Seat 3: hzane folded before Flop (didn't bet)
Seat 4: Mr. Amarelex folded before Flop (didn't bet)
Seat 5: roywjr folded before Flop (didn't bet)
Seat 6: pocketstuff folded before Flop (didn't bet)
Seat 7: capitao pt folded before Flop (didn't bet)
Seat 8: AndréGuaraci folded before Flop (didn't bet)
Seat 9: poony53 (button) folded before Flop (didn't bet)



PokerStars Hand #189422214589: Tournament #2367584539, 9000+1000 Hold'em No Limit - Level XVII (160/320) - 2018/08/01 22:11:39 ET
Table '2367584539 20' 9-max Seat #1 is the button
Seat 1: zocker131415 (6461 in chips) 
Seat 2: tins (1838 in chips) 
Seat 3: hzane (11221 in chips) 
Seat 4: Mr. Amarelex (13440 in chips) 
Seat 5: roywjr (2410 in chips) 
Seat 6: pocketstuff (26004 in chips) 
Seat 7: capitao pt (5237 in chips) 
Seat 8: AndréGuaraci (4986 in chips) 
Seat 9: poony53 (9025 in chips) 
zocker131415: posts the ante 32
tins: posts the ante 32
hzane: posts the ante 32
Mr. Amarelex: posts the ante 32
roywjr: posts the ante 32
pocketstuff: posts the ante 32
capitao pt: posts the ante 32
AndréGuaraci: posts the ante 32
poony53: posts the ante 32
tins: posts small blind 160
hzane: posts big blind 320
*** HOLE CARDS ***
Dealt to hzane [4h 2s]
Mr. Amarelex: calls 320
roywjr: folds 
pocketstuff: folds 
capitao pt: raises 640 to 960
AndréGuaraci: folds 
poony53: folds 
zocker131415: folds 
tins: calls 800
hzane: folds 
Mr. Amarelex: calls 640
*** FLOP *** [6s 2c 9h]
tins: checks 
Mr. Amarelex: checks 
capitao pt: bets 960
tins: calls 846 and is all-in
Mr. Amarelex: folds 
Uncalled bet (114) returned to capitao pt
*** TURN *** [6s 2c 9h] [Qc]
*** RIVER *** [6s 2c 9h Qc] [Kd]
*** SHOW DOWN ***
tins: shows [9d 8c] (a pair of Nines)
capitao pt: shows [Qh As] (a pair of Queens)
capitao pt collected 5180 from pot
tins finished the tournament in 106th place and received 15000.
*** SUMMARY ***
Total pot 5180 | Rake 0 
Board [6s 2c 9h Qc Kd]
Seat 1: zocker131415 (button) folded before Flop (didn't bet)
Seat 2: tins (small blind) showed [9d 8c] and lost with a pair of Nines
Seat 3: hzane (big blind) folded before Flop
Seat 4: Mr. Amarelex folded on the Flop
Seat 5: roywjr folded before Flop (didn't bet)
Seat 6: pocketstuff folded before Flop (didn't bet)
Seat 7: capitao pt showed [Qh As] and won (5180) with a pair of Queens
Seat 8: AndréGuaraci folded before Flop (didn't bet)
Seat 9: poony53 folded before Flop (didn't bet)



PokerStars Hand #189422232381: Tournament #2367584539, 9000+1000 Hold'em No Limit - Level XVIII (200/400) - 2018/08/01 22:12:37 ET
Table '2367584539 20' 9-max Seat #3 is the button
Seat 1: zocker131415 (6429 in chips) 
Seat 3: hzane (10869 in chips) 
Seat 4: Mr. Amarelex (12448 in chips) 
Seat 5: roywjr (2378 in chips) 
Seat 6: pocketstuff (25972 in chips) 
Seat 7: capitao pt (8579 in chips) 
Seat 8: AndréGuaraci (4954 in chips) 
Seat 9: poony53 (8993 in chips) 
zocker131415: posts the ante 40
hzane: posts the ante 40
Mr. Amarelex: posts the ante 40
roywjr: posts the ante 40
pocketstuff: posts the ante 40
capitao pt: posts the ante 40
AndréGuaraci: posts the ante 40
poony53: posts the ante 40
Mr. Amarelex: posts small blind 200
roywjr: posts big blind 400
*** HOLE CARDS ***
Dealt to hzane [2c 8d]
pocketstuff: folds 
capitao pt: raises 800 to 1200
AndréGuaraci: folds 
poony53: folds 
zocker131415: calls 1200
hzane: folds 
Mr. Amarelex: folds 
roywjr: folds 
*** FLOP *** [6c 3d Ts]
capitao pt: bets 1200
zocker131415: raises 3989 to 5189 and is all-in
capitao pt: calls 3989
*** TURN *** [6c 3d Ts] [6d]
*** RIVER *** [6c 3d Ts 6d] [Qs]
*** SHOW DOWN ***
capitao pt: shows [7h 7d] (two pair, Sevens and Sixes)
zocker131415: shows [8h 8c] (two pair, Eights and Sixes)
zocker131415 collected 13698 from pot
*** SUMMARY ***
Total pot 13698 | Rake 0 
Board [6c 3d Ts 6d Qs]
Seat 1: zocker131415 showed [8h 8c] and won (13698) with two pair, Eights and Sixes
Seat 3: hzane (button) folded before Flop (didn't bet)
Seat 4: Mr. Amarelex (small blind) folded before Flop
Seat 5: roywjr (big blind) folded before Flop
Seat 6: pocketstuff folded before Flop (didn't bet)
Seat 7: capitao pt showed [7h 7d] and lost with two pair, Sevens and Sixes
Seat 8: AndréGuaraci folded before Flop (didn't bet)
Seat 9: poony53 folded before Flop (didn't bet)



PokerStars Hand #189422248264: Tournament #2367584539, 9000+1000 Hold'em No Limit - Level XVIII (200/400) - 2018/08/01 22:13:27 ET
Table '2367584539 20' 9-max Seat #4 is the button
Seat 1: zocker131415 (13698 in chips) 
Seat 3: hzane (10829 in chips) 
Seat 4: Mr. Amarelex (12208 in chips) 
Seat 5: roywjr (1938 in chips) 
Seat 6: pocketstuff (25932 in chips) 
Seat 7: capitao pt (2150 in chips) 
Seat 8: AndréGuaraci (4914 in chips) 
Seat 9: poony53 (8953 in chips) 
zocker131415: posts the ante 40
hzane: posts the ante 40
Mr. Amarelex: posts the ante 40
roywjr: posts the ante 40
pocketstuff: posts the ante 40
capitao pt: posts the ante 40
AndréGuaraci: posts the ante 40
poony53: posts the ante 40
roywjr: posts small blind 200
pocketstuff: posts big blind 400
*** HOLE CARDS ***
Dealt to hzane [3c Jd]
capitao pt: folds 
AndréGuaraci: folds 
poony53: folds 
zocker131415: folds 
hzane: folds 
Mr. Amarelex: folds 
roywjr: calls 200
pocketstuff: checks 
*** FLOP *** [Jh Js 9c]
roywjr: checks 
pocketstuff: bets 1600
roywjr: folds 
Uncalled bet (1600) returned to pocketstuff
pocketstuff collected 1120 from pot
*** SUMMARY ***
Total pot 1120 | Rake 0 
Board [Jh Js 9c]
Seat 1: zocker131415 folded before Flop (didn't bet)
Seat 3: hzane folded before Flop (didn't bet)
Seat 4: Mr. Amarelex (button) folded before Flop (didn't bet)
Seat 5: roywjr (small blind) folded on the Flop
Seat 6: pocketstuff (big blind) collected (1120)
Seat 7: capitao pt folded before Flop (didn't bet)
Seat 8: AndréGuaraci folded before Flop (didn't bet)
Seat 9: poony53 folded before Flop (didn't bet)



PokerStars Hand #189422261490: Tournament #2367584539, 9000+1000 Hold'em No Limit - Level XVIII (200/400) - 2018/08/01 22:14:10 ET
Table '2367584539 20' 9-max Seat #5 is the button
Seat 1: zocker131415 (13658 in chips) 
Seat 3: hzane (10789 in chips) 
Seat 4: Mr. Amarelex (12168 in chips) 
Seat 5: roywjr (1498 in chips) 
Seat 6: pocketstuff (26612 in chips) 
Seat 7: capitao pt (2110 in chips) 
Seat 8: AndréGuaraci (4874 in chips) 
Seat 9: poony53 (8913 in chips) 
zocker131415: posts the ante 40
hzane: posts the ante 40
Mr. Amarelex: posts the ante 40
roywjr: posts the ante 40
pocketstuff: posts the ante 40
capitao pt: posts the ante 40
AndréGuaraci: posts the ante 40
poony53: posts the ante 40
pocketstuff: posts small blind 200
capitao pt: posts big blind 400
*** HOLE CARDS ***
Dealt to hzane [5c Kd]
AndréGuaraci: folds 
poony53: calls 400
zocker131415: calls 400
hzane: folds 
Mr. Amarelex: folds 
roywjr: folds 
pocketstuff: folds 
capitao pt: checks 
*** FLOP *** [4s Qc Th]
capitao pt: checks 
poony53: checks 
zocker131415: checks 
*** TURN *** [4s Qc Th] [Ad]
capitao pt: checks 
poony53: checks 
zocker131415: checks 
*** RIVER *** [4s Qc Th Ad] [8s]
capitao pt: checks 
poony53: bets 400
zocker131415: folds 
capitao pt: folds 
Uncalled bet (400) returned to poony53
poony53 collected 1720 from pot
poony53: doesn't show hand 
*** SUMMARY ***
Total pot 1720 | Rake 0 
Board [4s Qc Th Ad 8s]
Seat 1: zocker131415 folded on the River
Seat 3: hzane folded before Flop (didn't bet)
Seat 4: Mr. Amarelex folded before Flop (didn't bet)
Seat 5: roywjr (button) folded before Flop (didn't bet)
Seat 6: pocketstuff (small blind) folded before Flop
Seat 7: capitao pt (big blind) folded on the River
Seat 8: AndréGuaraci folded before Flop (didn't bet)
Seat 9: poony53 collected (1720)



PokerStars Hand #189422283238: Tournament #2367584539, 9000+1000 Hold'em No Limit - Level XIX (250/500) - 2018/08/01 22:15:18 ET
Table '2367584539 20' 9-max Seat #6 is the button
Seat 1: zocker131415 (13218 in chips) 
Seat 2: thefish1948 (6551 in chips) 
Seat 3: hzane (10749 in chips) 
Seat 4: Mr. Amarelex (12128 in chips) 
Seat 5: roywjr (1458 in chips) 
Seat 6: pocketstuff (26372 in chips) 
Seat 7: capitao pt (1670 in chips) 
Seat 8: AndréGuaraci (4834 in chips) 
Seat 9: poony53 (10193 in chips) 
zocker131415: posts the ante 50
thefish1948: posts the ante 50
hzane: posts the ante 50
Mr. Amarelex: posts the ante 50
roywjr: posts the ante 50
pocketstuff: posts the ante 50
capitao pt: posts the ante 50
AndréGuaraci: posts the ante 50
poony53: posts the ante 50
capitao pt: posts small blind 250
AndréGuaraci: posts big blind 500
*** HOLE CARDS ***
Dealt to hzane [Ad 4s]
poony53: folds 
zocker131415: folds 
thefish1948: calls 500
hzane: folds 
Mr. Amarelex: calls 500
roywjr: folds 
pocketstuff: folds 
capitao pt: calls 250
AndréGuaraci: raises 500 to 1000
thefish1948: calls 500
Mr. Amarelex: calls 500
capitao pt: calls 500
*** FLOP *** [6c Ks 2c]
capitao pt: bets 620 and is all-in
AndréGuaraci: calls 620
thefish1948: folds 
Mr. Amarelex: calls 620
*** TURN *** [6c Ks 2c] [Td]
AndréGuaraci: checks 
Mr. Amarelex: bets 2500
AndréGuaraci: calls 2500
*** RIVER *** [6c Ks 2c Td] [3d]
AndréGuaraci: checks 
Mr. Amarelex: bets 1000
AndréGuaraci: calls 664 and is all-in
Uncalled bet (336) returned to Mr. Amarelex
*** SHOW DOWN ***
Mr. Amarelex: shows [Qc Kd] (a pair of Kings)
AndréGuaraci: shows [Jd As] (high card Ace)
Mr. Amarelex collected 6328 from side pot
capitao pt: shows [7h 2s] (a pair of Deuces)
Mr. Amarelex collected 6310 from main pot
AndréGuaraci finished the tournament in 86th place and received 17000.
capitao pt finished the tournament in 87th place and received 17000.
*** SUMMARY ***
Total pot 12638 Main pot 6310. Side pot 6328. | Rake 0 
Board [6c Ks 2c Td 3d]
Seat 1: zocker131415 folded before Flop (didn't bet)
Seat 2: thefish1948 folded on the Flop
Seat 3: hzane folded before Flop (didn't bet)
Seat 4: Mr. Amarelex showed [Qc Kd] and won (12638) with a pair of Kings
Seat 5: roywjr folded before Flop (didn't bet)
Seat 6: pocketstuff (button) folded before Flop (didn't bet)
Seat 7: capitao pt (small blind) showed [7h 2s] and lost with a pair of Deuces
Seat 8: AndréGuaraci (big blind) showed [Jd As] and lost with high card Ace
Seat 9: poony53 folded before Flop (didn't bet)



PokerStars Hand #189422316114: Tournament #2367584539, 9000+1000 Hold'em No Limit - Level XIX (250/500) - 2018/08/01 22:17:03 ET
Table '2367584539 20' 9-max Seat #9 is the button
Seat 1: zocker131415 (13168 in chips) 
Seat 2: thefish1948 (5501 in chips) 
Seat 3: hzane (10699 in chips) 
Seat 4: Mr. Amarelex (19932 in chips) 
Seat 5: roywjr (1408 in chips) 
Seat 6: pocketstuff (26322 in chips) 
Seat 9: poony53 (10143 in chips) 
zocker131415: posts the ante 50
thefish1948: posts the ante 50
hzane: posts the ante 50
Mr. Amarelex: posts the ante 50
roywjr: posts the ante 50
pocketstuff: posts the ante 50
poony53: posts the ante 50
zocker131415: posts small blind 250
thefish1948: posts big blind 500
*** HOLE CARDS ***
Dealt to hzane [8s Kh]
hzane: raises 500 to 1000
Mr. Amarelex: folds 
roywjr: folds 
pocketstuff: folds 
poony53: folds 
zocker131415: folds 
thefish1948: folds 
Uncalled bet (500) returned to hzane
hzane collected 1600 from pot
*** SUMMARY ***
Total pot 1600 | Rake 0 
Seat 1: zocker131415 (small blind) folded before Flop
Seat 2: thefish1948 (big blind) folded before Flop
Seat 3: hzane collected (1600)
Seat 4: Mr. Amarelex folded before Flop (didn't bet)
Seat 5: roywjr folded before Flop (didn't bet)
Seat 6: pocketstuff folded before Flop (didn't bet)
Seat 9: poony53 (button) folded before Flop (didn't bet)



PokerStars Hand #189422326595: Tournament #2367584539, 9000+1000 Hold'em No Limit - Level XIX (250/500) - 2018/08/01 22:17:37 ET
Table '2367584539 20' 9-max Seat #1 is the button
Seat 1: zocker131415 (12868 in chips) 
Seat 2: thefish1948 (4951 in chips) 
Seat 3: hzane (11749 in chips) 
Seat 4: Mr. Amarelex (19882 in chips) 
Seat 5: roywjr (1358 in chips) 
Seat 6: pocketstuff (26272 in chips) 
Seat 7: FDB57 (16887 in chips) 
Seat 9: poony53 (10093 in chips) 
zocker131415: posts the ante 50
thefish1948: posts the ante 50
hzane: posts the ante 50
Mr. Amarelex: posts the ante 50
roywjr: posts the ante 50
pocketstuff: posts the ante 50
FDB57: posts the ante 50
poony53: posts the ante 50
thefish1948: posts small blind 250
hzane: posts big blind 500
*** HOLE CARDS ***
Dealt to hzane [Ah 6d]
Mr. Amarelex: calls 500
roywjr: folds 
pocketstuff: calls 500
FDB57: folds 
poony53: folds 
zocker131415: folds 
thefish1948: folds 
hzane: checks 
*** FLOP *** [5s Th 2d]
hzane: bets 500
Mr. Amarelex: folds 
pocketstuff: calls 500
*** TURN *** [5s Th 2d] [6s]
hzane: bets 500
pocketstuff: calls 500
*** RIVER *** [5s Th 2d 6s] [Qs]
hzane: checks 
pocketstuff: checks 
*** SHOW DOWN ***
hzane: shows [Ah 6d] (a pair of Sixes)
pocketstuff: shows [8h 8c] (a pair of Eights)
pocketstuff collected 4150 from pot
*** SUMMARY ***
Total pot 4150 | Rake 0 
Board [5s Th 2d 6s Qs]
Seat 1: zocker131415 (button) folded before Flop (didn't bet)
Seat 2: thefish1948 (small blind) folded before Flop
Seat 3: hzane (big blind) showed [Ah 6d] and lost with a pair of Sixes
Seat 4: Mr. Amarelex folded on the Flop
Seat 5: roywjr folded before Flop (didn't bet)
Seat 6: pocketstuff showed [8h 8c] and won (4150) with a pair of Eights
Seat 7: FDB57 folded before Flop (didn't bet)
Seat 9: poony53 folded before Flop (didn't bet)



PokerStars Hand #189422345829: Tournament #2367584539, 9000+1000 Hold'em No Limit - Level XX (300/600) - 2018/08/01 22:18:39 ET
Table '2367584539 20' 9-max Seat #2 is the button
Seat 1: zocker131415 (12818 in chips) 
Seat 2: thefish1948 (4651 in chips) 
Seat 3: hzane (10199 in chips) 
Seat 4: Mr. Amarelex (19332 in chips) 
Seat 5: roywjr (1308 in chips) 
Seat 6: pocketstuff (28872 in chips) 
Seat 7: FDB57 (16837 in chips) 
Seat 8: lantern16 (2466 in chips) 
Seat 9: poony53 (10043 in chips) 
zocker131415: posts the ante 60
thefish1948: posts the ante 60
hzane: posts the ante 60
Mr. Amarelex: posts the ante 60
roywjr: posts the ante 60
pocketstuff: posts the ante 60
FDB57: posts the ante 60
lantern16: posts the ante 60
poony53: posts the ante 60
hzane: posts small blind 300
Mr. Amarelex: posts big blind 600
*** HOLE CARDS ***
Dealt to hzane [Qh Th]
roywjr: raises 648 to 1248 and is all-in
pocketstuff: folds 
FDB57: folds 
lantern16: folds 
poony53: folds 
zocker131415: calls 1248
thefish1948: folds 
hzane: calls 948
Mr. Amarelex: calls 648
*** FLOP *** [4c 2d Jc]
hzane: checks 
Mr. Amarelex: checks 
zocker131415: bets 5400
hzane: folds 
Mr. Amarelex: folds 
Uncalled bet (5400) returned to zocker131415
*** TURN *** [4c 2d Jc] [8h]
*** RIVER *** [4c 2d Jc 8h] [Ad]
*** SHOW DOWN ***
roywjr: shows [7h 7c] (a pair of Sevens)
zocker131415: shows [3h 3c] (a pair of Threes)
roywjr collected 5532 from pot
*** SUMMARY ***
Total pot 5532 | Rake 0 
Board [4c 2d Jc 8h Ad]
Seat 1: zocker131415 showed [3h 3c] and lost with a pair of Threes
Seat 2: thefish1948 (button) folded before Flop (didn't bet)
Seat 3: hzane (small blind) folded on the Flop
Seat 4: Mr. Amarelex (big blind) folded on the Flop
Seat 5: roywjr showed [7h 7c] and won (5532) with a pair of Sevens
Seat 6: pocketstuff folded before Flop (didn't bet)
Seat 7: FDB57 folded before Flop (didn't bet)
Seat 8: lantern16 folded before Flop (didn't bet)
Seat 9: poony53 folded before Flop (didn't bet)



PokerStars Hand #189422362934: Tournament #2367584539, 9000+1000 Hold'em No Limit - Level XX (300/600) - 2018/08/01 22:19:34 ET
Table '2367584539 20' 9-max Seat #3 is the button
Seat 1: zocker131415 (11510 in chips) 
Seat 2: thefish1948 (4591 in chips) 
Seat 3: hzane (8891 in chips) 
Seat 4: Mr. Amarelex (18024 in chips) 
Seat 5: roywjr (5532 in chips) 
Seat 6: pocketstuff (28812 in chips) 
Seat 7: FDB57 (16777 in chips) 
Seat 8: lantern16 (2406 in chips) 
Seat 9: poony53 (9983 in chips) 
zocker131415: posts the ante 60
thefish1948: posts the ante 60
hzane: posts the ante 60
Mr. Amarelex: posts the ante 60
roywjr: posts the ante 60
pocketstuff: posts the ante 60
FDB57: posts the ante 60
lantern16: posts the ante 60
poony53: posts the ante 60
Mr. Amarelex: posts small blind 300
roywjr: posts big blind 600
*** HOLE CARDS ***
Dealt to hzane [5s 2s]
pocketstuff: folds 
FDB57: folds 
lantern16: folds 
poony53: calls 600
zocker131415: folds 
thefish1948: calls 600
hzane: folds 
Mr. Amarelex: calls 300
roywjr: checks 
*** FLOP *** [4d 5c Qh]
Mr. Amarelex: checks 
roywjr: bets 600
poony53: raises 4140 to 4740
thefish1948: folds 
Mr. Amarelex: folds 
roywjr: folds 
Uncalled bet (4140) returned to poony53
poony53 collected 4140 from pot
poony53: doesn't show hand 
*** SUMMARY ***
Total pot 4140 | Rake 0 
Board [4d 5c Qh]
Seat 1: zocker131415 folded before Flop (didn't bet)
Seat 2: thefish1948 folded on the Flop
Seat 3: hzane (button) folded before Flop (didn't bet)
Seat 4: Mr. Amarelex (small blind) folded on the Flop
Seat 5: roywjr (big blind) folded on the Flop
Seat 6: pocketstuff folded before Flop (didn't bet)
Seat 7: FDB57 folded before Flop (didn't bet)
Seat 8: lantern16 folded before Flop (didn't bet)
Seat 9: poony53 collected (4140)



PokerStars Hand #189422376466: Tournament #2367584539, 9000+1000 Hold'em No Limit - Level XX (300/600) - 2018/08/01 22:20:17 ET
Table '2367584539 20' 9-max Seat #4 is the button
Seat 1: zocker131415 (11450 in chips) 
Seat 2: thefish1948 (3931 in chips) 
Seat 3: hzane (8831 in chips) 
Seat 4: Mr. Amarelex (17364 in chips) 
Seat 5: roywjr (4272 in chips) 
Seat 6: pocketstuff (28752 in chips) 
Seat 7: FDB57 (16717 in chips) 
Seat 8: lantern16 (2346 in chips) 
Seat 9: poony53 (12863 in chips) 
zocker131415: posts the ante 60
thefish1948: posts the ante 60
hzane: posts the ante 60
Mr. Amarelex: posts the ante 60
roywjr: posts the ante 60
pocketstuff: posts the ante 60
FDB57: posts the ante 60
lantern16: posts the ante 60
poony53: posts the ante 60
roywjr: posts small blind 300
pocketstuff: posts big blind 600
*** HOLE CARDS ***
Dealt to hzane [Jd Qs]
FDB57: folds 
lantern16: folds 
poony53: folds 
zocker131415: folds 
Mr. Amarelex said, "kkkkk"
thefish1948: folds 
hzane: calls 600
Mr. Amarelex: folds 
roywjr: calls 300
pocketstuff: checks 
*** FLOP *** [Jh 7h Kh]
roywjr: checks 
pocketstuff: checks 
hzane: bets 1200
roywjr: folds 
pocketstuff: calls 1200
*** TURN *** [Jh 7h Kh] [Js]
pocketstuff: checks 
hzane: bets 1200
pocketstuff: calls 1200
*** RIVER *** [Jh 7h Kh Js] [6d]
pocketstuff: checks 
hzane: bets 3000
pocketstuff: calls 3000
*** SHOW DOWN ***
hzane: shows [Jd Qs] (three of a kind, Jacks)
pocketstuff: mucks hand 
hzane collected 13140 from pot
*** SUMMARY ***
Total pot 13140 | Rake 0 
Board [Jh 7h Kh Js 6d]
Seat 1: zocker131415 folded before Flop (didn't bet)
Seat 2: thefish1948 folded before Flop (didn't bet)
Seat 3: hzane showed [Jd Qs] and won (13140) with three of a kind, Jacks
Seat 4: Mr. Amarelex (button) folded before Flop (didn't bet)
Seat 5: roywjr (small blind) folded on the Flop
Seat 6: pocketstuff (big blind) mucked [Ah 8s]
Seat 7: FDB57 folded before Flop (didn't bet)
Seat 8: lantern16 folded before Flop (didn't bet)
Seat 9: poony53 folded before Flop (didn't bet)



PokerStars Hand #189422401926: Tournament #2367584539, 9000+1000 Hold'em No Limit - Level XXI (350/700) - 2018/08/01 22:21:23 ET
Table '2367584539 20' 9-max Seat #5 is the button
Seat 1: zocker131415 (11390 in chips) 
Seat 2: thefish1948 (3871 in chips) 
Seat 3: hzane (15911 in chips) 
Seat 4: Mr. Amarelex (17304 in chips) 
Seat 5: roywjr (3612 in chips) 
Seat 6: pocketstuff (22692 in chips) 
Seat 7: FDB57 (16657 in chips) 
Seat 8: lantern16 (2286 in chips) 
Seat 9: poony53 (12803 in chips) 
zocker131415: posts the ante 70
thefish1948: posts the ante 70
hzane: posts the ante 70
Mr. Amarelex: posts the ante 70
roywjr: posts the ante 70
pocketstuff: posts the ante 70
FDB57: posts the ante 70
lantern16: posts the ante 70
poony53: posts the ante 70
pocketstuff: posts small blind 350
FDB57: posts big blind 700
*** HOLE CARDS ***
Dealt to hzane [7h Kc]
lantern16: folds 
poony53: folds 
zocker131415: folds 
thefish1948: folds 
hzane: calls 700
Mr. Amarelex: folds 
roywjr: folds 
pocketstuff: calls 350
FDB57: checks 
*** FLOP *** [Kh Qs Kd]
pocketstuff: checks 
FDB57: checks 
hzane: bets 700
pocketstuff: calls 700
FDB57: calls 700
*** TURN *** [Kh Qs Kd] [5d]
pocketstuff: checks 
FDB57: checks 
hzane: bets 700
pocketstuff: calls 700
FDB57: calls 700
*** RIVER *** [Kh Qs Kd 5d] [As]
pocketstuff: checks 
FDB57: checks 
hzane: bets 2100
pocketstuff: raises 2100 to 4200
FDB57: folds 
hzane: raises 2800 to 7000
pocketstuff: calls 2800
*** SHOW DOWN ***
hzane: shows [7h Kc] (three of a kind, Kings)
pocketstuff: mucks hand 
hzane collected 20930 from pot
*** SUMMARY ***
Total pot 20930 | Rake 0 
Board [Kh Qs Kd 5d As]
Seat 1: zocker131415 folded before Flop (didn't bet)
Seat 2: thefish1948 folded before Flop (didn't bet)
Seat 3: hzane showed [7h Kc] and won (20930) with three of a kind, Kings
Seat 4: Mr. Amarelex folded before Flop (didn't bet)
Seat 5: roywjr (button) folded before Flop (didn't bet)
Seat 6: pocketstuff (small blind) mucked [Ah Jd]
Seat 7: FDB57 (big blind) folded on the River
Seat 8: lantern16 folded before Flop (didn't bet)
Seat 9: poony53 folded before Flop (didn't bet)



PokerStars Hand #189422426195: Tournament #2367584539, 9000+1000 Hold'em No Limit - Level XXI (350/700) - 2018/08/01 22:22:42 ET
Table '2367584539 20' 9-max Seat #6 is the button
Seat 1: zocker131415 (11320 in chips) 
Seat 3: hzane (27671 in chips) 
Seat 4: Mr. Amarelex (17234 in chips) 
Seat 5: roywjr (3542 in chips) 
Seat 6: pocketstuff (13522 in chips) 
Seat 7: FDB57 (14487 in chips) 
Seat 8: lantern16 (2216 in chips) 
Seat 9: poony53 (12733 in chips) 
zocker131415: posts the ante 70
hzane: posts the ante 70
Mr. Amarelex: posts the ante 70
roywjr: posts the ante 70
pocketstuff: posts the ante 70
FDB57: posts the ante 70
lantern16: posts the ante 70
poony53: posts the ante 70
FDB57: posts small blind 350
lantern16: posts big blind 700
*** HOLE CARDS ***
Dealt to hzane [Jh Th]
poony53: calls 700
zocker131415: folds 
hzane: calls 700
Mr. Amarelex: folds 
roywjr: calls 700
pocketstuff: folds 
FDB57: calls 350
lantern16: checks 
*** FLOP *** [Td 7d 5h]
FDB57: checks 
lantern16: checks 
poony53: checks 
hzane: bets 2100
roywjr: raises 672 to 2772 and is all-in
FDB57: folds 
lantern16: folds 
poony53: folds 
hzane: calls 672
*** TURN *** [Td 7d 5h] [Jc]
*** RIVER *** [Td 7d 5h Jc] [6s]
*** SHOW DOWN ***
hzane: shows [Jh Th] (two pair, Jacks and Tens)
roywjr: shows [Tc Ac] (a pair of Tens)
hzane collected 9604 from pot
roywjr finished the tournament in 70th place and received 22000.
*** SUMMARY ***
Total pot 9604 | Rake 0 
Board [Td 7d 5h Jc 6s]
Seat 1: zocker131415 folded before Flop (didn't bet)
Seat 3: hzane showed [Jh Th] and won (9604) with two pair, Jacks and Tens
Seat 4: Mr. Amarelex folded before Flop (didn't bet)
Seat 5: roywjr showed [Tc Ac] and lost with a pair of Tens
Seat 6: pocketstuff (button) folded before Flop (didn't bet)
Seat 7: FDB57 (small blind) folded on the Flop
Seat 8: lantern16 (big blind) folded on the Flop
Seat 9: poony53 folded on the Flop



PokerStars Hand #189422442733: Tournament #2367584539, 9000+1000 Hold'em No Limit - Level XXI (350/700) - 2018/08/01 22:23:35 ET
Table '2367584539 20' 9-max Seat #7 is the button
Seat 1: zocker131415 (11250 in chips) 
Seat 2: DIDISATELITE (4525 in chips) 
Seat 3: hzane (33733 in chips) 
Seat 4: Mr. Amarelex (17164 in chips) 
Seat 6: pocketstuff (13452 in chips) 
Seat 7: FDB57 (13717 in chips) 
Seat 8: lantern16 (1446 in chips) 
Seat 9: poony53 (11963 in chips) 
zocker131415: posts the ante 70
DIDISATELITE: posts the ante 70
hzane: posts the ante 70
Mr. Amarelex: posts the ante 70
pocketstuff: posts the ante 70
FDB57: posts the ante 70
lantern16: posts the ante 70
poony53: posts the ante 70
lantern16: posts small blind 350
poony53: posts big blind 700
*** HOLE CARDS ***
Dealt to hzane [As 7d]
zocker131415: folds 
DIDISATELITE: folds 
hzane: calls 700
Mr. Amarelex: folds 
pocketstuff: folds 
FDB57: calls 700
lantern16: calls 350
poony53: checks 
*** FLOP *** [Ad 4s 3h]
lantern16: checks 
poony53: checks 
hzane: bets 700
FDB57: folds 
lantern16: folds 
poony53: calls 700
*** TURN *** [Ad 4s 3h] [7h]
poony53: checks 
hzane: bets 700
poony53: folds 
Uncalled bet (700) returned to hzane
hzane collected 4760 from pot
*** SUMMARY ***
Total pot 4760 | Rake 0 
Board [Ad 4s 3h 7h]
Seat 1: zocker131415 folded before Flop (didn't bet)
Seat 2: DIDISATELITE folded before Flop (didn't bet)
Seat 3: hzane collected (4760)
Seat 4: Mr. Amarelex folded before Flop (didn't bet)
Seat 6: pocketstuff folded before Flop (didn't bet)
Seat 7: FDB57 (button) folded on the Flop
Seat 8: lantern16 (small blind) folded on the Flop
Seat 9: poony53 (big blind) folded on the Turn



PokerStars Hand #189422457523: Tournament #2367584539, 9000+1000 Hold'em No Limit - Level XXII (400/800) - 2018/08/01 22:24:23 ET
Table '2367584539 20' 9-max Seat #8 is the button
Seat 1: zocker131415 (11180 in chips) 
Seat 2: DIDISATELITE (4455 in chips) 
Seat 3: hzane (37023 in chips) 
Seat 4: Mr. Amarelex (17094 in chips) 
Seat 6: pocketstuff (13382 in chips) 
Seat 7: FDB57 (12947 in chips) 
Seat 8: lantern16 (676 in chips) 
Seat 9: poony53 (10493 in chips) 
zocker131415: posts the ante 80
DIDISATELITE: posts the ante 80
hzane: posts the ante 80
Mr. Amarelex: posts the ante 80
pocketstuff: posts the ante 80
FDB57: posts the ante 80
lantern16: posts the ante 80
poony53: posts the ante 80
poony53: posts small blind 400
zocker131415: posts big blind 800
*** HOLE CARDS ***
Dealt to hzane [Qh 3c]
DIDISATELITE: folds 
hzane: folds 
Mr. Amarelex: folds 
pocketstuff: folds 
FDB57: calls 800
lantern16: calls 596 and is all-in
poony53: calls 400
zocker131415: checks 
*** FLOP *** [2d 3d 5c]
poony53: checks 
zocker131415: checks 
FDB57: checks 
*** TURN *** [2d 3d 5c] [Ac]
poony53: bets 800
zocker131415: folds 
FDB57: folds 
Uncalled bet (800) returned to poony53
*** RIVER *** [2d 3d 5c Ac] [6h]
*** SHOW DOWN ***
poony53: shows [7d Ah] (a pair of Aces)
poony53 collected 612 from side pot
lantern16: shows [6d 5s] (two pair, Sixes and Fives)
lantern16 collected 3024 from main pot
*** SUMMARY ***
Total pot 3636 Main pot 3024. Side pot 612. | Rake 0 
Board [2d 3d 5c Ac 6h]
Seat 1: zocker131415 (big blind) folded on the Turn
Seat 2: DIDISATELITE folded before Flop (didn't bet)
Seat 3: hzane folded before Flop (didn't bet)
Seat 4: Mr. Amarelex folded before Flop (didn't bet)
Seat 6: pocketstuff folded before Flop (didn't bet)
Seat 7: FDB57 folded on the Turn
Seat 8: lantern16 (button) showed [6d 5s] and won (3024) with two pair, Sixes and Fives
Seat 9: poony53 (small blind) showed [7d Ah] and won (612) with a pair of Aces



PokerStars Hand #189422468416: Tournament #2367584539, 9000+1000 Hold'em No Limit - Level XXII (400/800) - 2018/08/01 22:24:59 ET
Table '2367584539 20' 9-max Seat #9 is the button
Seat 1: zocker131415 (10300 in chips) 
Seat 2: DIDISATELITE (4375 in chips) 
Seat 3: hzane (36943 in chips) 
Seat 4: Mr. Amarelex (17014 in chips) 
Seat 6: pocketstuff (13302 in chips) 
Seat 7: FDB57 (12067 in chips) 
Seat 8: lantern16 (3024 in chips) 
Seat 9: poony53 (10225 in chips) 
zocker131415: posts the ante 80
DIDISATELITE: posts the ante 80
hzane: posts the ante 80
Mr. Amarelex: posts the ante 80
pocketstuff: posts the ante 80
FDB57: posts the ante 80
lantern16: posts the ante 80
poony53: posts the ante 80
zocker131415: posts small blind 400
DIDISATELITE: posts big blind 800
*** HOLE CARDS ***
Dealt to hzane [Jd 8d]
hzane: calls 800
Mr. Amarelex: folds 
pocketstuff: folds 
FDB57: folds 
lantern16: folds 
poony53: folds 
zocker131415: calls 400
DIDISATELITE: checks 
*** FLOP *** [6h 5s Kc]
zocker131415: checks 
DIDISATELITE: checks 
hzane: bets 800
zocker131415: folds 
DIDISATELITE: folds 
Uncalled bet (800) returned to hzane
hzane collected 3040 from pot
*** SUMMARY ***
Total pot 3040 | Rake 0 
Board [6h 5s Kc]
Seat 1: zocker131415 (small blind) folded on the Flop
Seat 2: DIDISATELITE (big blind) folded on the Flop
Seat 3: hzane collected (3040)
Seat 4: Mr. Amarelex folded before Flop (didn't bet)
Seat 6: pocketstuff folded before Flop (didn't bet)
Seat 7: FDB57 folded before Flop (didn't bet)
Seat 8: lantern16 folded before Flop (didn't bet)
Seat 9: poony53 (button) folded before Flop (didn't bet)



PokerStars Hand #189422479662: Tournament #2367584539, 9000+1000 Hold'em No Limit - Level XXII (400/800) - 2018/08/01 22:25:35 ET
Table '2367584539 20' 9-max Seat #1 is the button
Seat 1: zocker131415 (9420 in chips) 
Seat 2: DIDISATELITE (3495 in chips) 
Seat 3: hzane (39103 in chips) 
Seat 4: Mr. Amarelex (16934 in chips) 
Seat 5: thgo_zo (4484 in chips) 
Seat 6: pocketstuff (13222 in chips) 
Seat 7: FDB57 (11987 in chips) 
Seat 8: lantern16 (2944 in chips) 
Seat 9: poony53 (10145 in chips) 
zocker131415: posts the ante 80
DIDISATELITE: posts the ante 80
hzane: posts the ante 80
Mr. Amarelex: posts the ante 80
thgo_zo: posts the ante 80
pocketstuff: posts the ante 80
FDB57: posts the ante 80
lantern16: posts the ante 80
poony53: posts the ante 80
DIDISATELITE: posts small blind 400
hzane: posts big blind 800
*** HOLE CARDS ***
Dealt to hzane [Tc Th]
Mr. Amarelex: folds 
thgo_zo: calls 800
pocketstuff: calls 800
FDB57: folds 
lantern16: folds 
poony53: calls 800
zocker131415: folds 
DIDISATELITE: folds 
hzane: raises 1600 to 2400
thgo_zo: calls 1600
pocketstuff: calls 1600
poony53: calls 1600
*** FLOP *** [8h 6c 5c]
hzane: bets 2400
thgo_zo: calls 2004 and is all-in
pocketstuff: folds 
poony53: folds 
Uncalled bet (396) returned to hzane
*** TURN *** [8h 6c 5c] [Js]
*** RIVER *** [8h 6c 5c Js] [Ah]
*** SHOW DOWN ***
hzane: shows [Tc Th] (a pair of Tens)
thgo_zo: shows [6s 6d] (three of a kind, Sixes)
thgo_zo collected 14728 from pot
*** SUMMARY ***
Total pot 14728 | Rake 0 
Board [8h 6c 5c Js Ah]
Seat 1: zocker131415 (button) folded before Flop (didn't bet)
Seat 2: DIDISATELITE (small blind) folded before Flop
Seat 3: hzane (big blind) showed [Tc Th] and lost with a pair of Tens
Seat 4: Mr. Amarelex folded before Flop (didn't bet)
Seat 5: thgo_zo showed [6s 6d] and won (14728) with three of a kind, Sixes
Seat 6: pocketstuff folded on the Flop
Seat 7: FDB57 folded before Flop (didn't bet)
Seat 8: lantern16 folded before Flop (didn't bet)
Seat 9: poony53 folded on the Flop



PokerStars Hand #189422493312: Tournament #2367584539, 9000+1000 Hold'em No Limit - Level XXII (400/800) - 2018/08/01 22:26:20 ET
Table '2367584539 20' 9-max Seat #2 is the button
Seat 1: zocker131415 (9340 in chips) 
Seat 2: DIDISATELITE (3015 in chips) 
Seat 3: hzane (34619 in chips) 
Seat 4: Mr. Amarelex (16854 in chips) 
Seat 5: thgo_zo (14728 in chips) 
Seat 6: pocketstuff (10742 in chips) 
Seat 7: FDB57 (11907 in chips) 
Seat 8: lantern16 (2864 in chips) 
Seat 9: poony53 (7665 in chips) 
zocker131415: posts the ante 80
DIDISATELITE: posts the ante 80
hzane: posts the ante 80
Mr. Amarelex: posts the ante 80
thgo_zo: posts the ante 80
pocketstuff: posts the ante 80
FDB57: posts the ante 80
lantern16: posts the ante 80
poony53: posts the ante 80
hzane: posts small blind 400
Mr. Amarelex: posts big blind 800
*** HOLE CARDS ***
Dealt to hzane [Qh Jh]
thgo_zo: folds 
pocketstuff: folds 
FDB57: calls 800
lantern16: calls 800
poony53: folds 
zocker131415: calls 800
DIDISATELITE: folds 
hzane: calls 400
Mr. Amarelex: checks 
*** FLOP *** [Kd 5c Ks]
hzane: bets 800
Mr. Amarelex: folds 
FDB57: calls 800
lantern16: folds 
zocker131415: folds 
*** TURN *** [Kd 5c Ks] [8d]
hzane: checks 
FDB57: checks 
*** RIVER *** [Kd 5c Ks 8d] [6h]
hzane: checks 
FDB57: checks 
*** SHOW DOWN ***
hzane: shows [Qh Jh] (a pair of Kings)
FDB57: shows [4h 4s] (two pair, Kings and Fours)
FDB57 collected 6320 from pot
*** SUMMARY ***
Total pot 6320 | Rake 0 
Board [Kd 5c Ks 8d 6h]
Seat 1: zocker131415 folded on the Flop
Seat 2: DIDISATELITE (button) folded before Flop (didn't bet)
Seat 3: hzane (small blind) showed [Qh Jh] and lost with a pair of Kings
Seat 4: Mr. Amarelex (big blind) folded on the Flop
Seat 5: thgo_zo folded before Flop (didn't bet)
Seat 6: pocketstuff folded before Flop (didn't bet)
Seat 7: FDB57 showed [4h 4s] and won (6320) with two pair, Kings and Fours
Seat 8: lantern16 folded on the Flop
Seat 9: poony53 folded before Flop (didn't bet)



PokerStars Hand #189422508105: Tournament #2367584539, 9000+1000 Hold'em No Limit - Level XXII (400/800) - 2018/08/01 22:27:09 ET
Table '2367584539 20' 9-max Seat #3 is the button
Seat 1: zocker131415 (8460 in chips) 
Seat 2: DIDISATELITE (2935 in chips) 
Seat 3: hzane (32939 in chips) 
Seat 4: Mr. Amarelex (15974 in chips) 
Seat 5: thgo_zo (14648 in chips) 
Seat 6: pocketstuff (10662 in chips) 
Seat 7: FDB57 (16547 in chips) 
Seat 8: lantern16 (1984 in chips) 
Seat 9: poony53 (7585 in chips) 
zocker131415: posts the ante 80
DIDISATELITE: posts the ante 80
hzane: posts the ante 80
Mr. Amarelex: posts the ante 80
thgo_zo: posts the ante 80
pocketstuff: posts the ante 80
FDB57: posts the ante 80
lantern16: posts the ante 80
poony53: posts the ante 80
Mr. Amarelex: posts small blind 400
thgo_zo: posts big blind 800
*** HOLE CARDS ***
Dealt to hzane [2s 3s]
pocketstuff: calls 800
FDB57: folds 
lantern16: folds 
poony53: folds 
zocker131415: folds 
DIDISATELITE: folds 
hzane: calls 800
Mr. Amarelex: calls 400
thgo_zo: checks 
*** FLOP *** [Td 8h 3c]
Mr. Amarelex: checks 
thgo_zo: checks 
pocketstuff: checks 
hzane: checks 
*** TURN *** [Td 8h 3c] [Ac]
Mr. Amarelex: bets 1600
thgo_zo: folds 
pocketstuff: folds 
hzane: folds 
Uncalled bet (1600) returned to Mr. Amarelex
Mr. Amarelex collected 3920 from pot
Mr. Amarelex: doesn't show hand 
*** SUMMARY ***
Total pot 3920 | Rake 0 
Board [Td 8h 3c Ac]
Seat 1: zocker131415 folded before Flop (didn't bet)
Seat 2: DIDISATELITE folded before Flop (didn't bet)
Seat 3: hzane (button) folded on the Turn
Seat 4: Mr. Amarelex (small blind) collected (3920)
Seat 5: thgo_zo (big blind) folded on the Turn
Seat 6: pocketstuff folded on the Turn
Seat 7: FDB57 folded before Flop (didn't bet)
Seat 8: lantern16 folded before Flop (didn't bet)
Seat 9: poony53 folded before Flop (didn't bet)



PokerStars Hand #189422520480: Tournament #2367584539, 9000+1000 Hold'em No Limit - Level XXIII (500/1000) - 2018/08/01 22:27:50 ET
Table '2367584539 20' 9-max Seat #4 is the button
Seat 1: zocker131415 (8380 in chips) 
Seat 2: DIDISATELITE (2855 in chips) 
Seat 3: hzane (32059 in chips) 
Seat 4: Mr. Amarelex (19014 in chips) 
Seat 5: thgo_zo (13768 in chips) 
Seat 6: pocketstuff (9782 in chips) 
Seat 7: FDB57 (16467 in chips) 
Seat 8: lantern16 (1904 in chips) 
Seat 9: poony53 (7505 in chips) 
zocker131415: posts the ante 100
DIDISATELITE: posts the ante 100
hzane: posts the ante 100
Mr. Amarelex: posts the ante 100
thgo_zo: posts the ante 100
pocketstuff: posts the ante 100
FDB57: posts the ante 100
lantern16: posts the ante 100
poony53: posts the ante 100
thgo_zo: posts small blind 500
pocketstuff: posts big blind 1000
*** HOLE CARDS ***
Dealt to hzane [Td 2c]
FDB57: folds 
lantern16: folds 
poony53: calls 1000
zocker131415: folds 
DIDISATELITE: folds 
hzane: folds 
Mr. Amarelex: folds 
thgo_zo: calls 500
pocketstuff: checks 
*** FLOP *** [Qh 2s 9c]
thgo_zo: checks 
pocketstuff: checks 
poony53: bets 3900
thgo_zo: folds 
pocketstuff: folds 
Uncalled bet (3900) returned to poony53
poony53 collected 3900 from pot
poony53: doesn't show hand 
*** SUMMARY ***
Total pot 3900 | Rake 0 
Board [Qh 2s 9c]
Seat 1: zocker131415 folded before Flop (didn't bet)
Seat 2: DIDISATELITE folded before Flop (didn't bet)
Seat 3: hzane folded before Flop (didn't bet)
Seat 4: Mr. Amarelex (button) folded before Flop (didn't bet)
Seat 5: thgo_zo (small blind) folded on the Flop
Seat 6: pocketstuff (big blind) folded on the Flop
Seat 7: FDB57 folded before Flop (didn't bet)
Seat 8: lantern16 folded before Flop (didn't bet)
Seat 9: poony53 collected (3900)



PokerStars Hand #189422530438: Tournament #2367584539, 9000+1000 Hold'em No Limit - Level XXIII (500/1000) - 2018/08/01 22:28:23 ET
Table '2367584539 20' 9-max Seat #5 is the button
Seat 1: zocker131415 (8280 in chips) 
Seat 2: DIDISATELITE (2755 in chips) 
Seat 3: hzane (31959 in chips) 
Seat 4: Mr. Amarelex (18914 in chips) 
Seat 5: thgo_zo (12668 in chips) 
Seat 6: pocketstuff (8682 in chips) 
Seat 7: FDB57 (16367 in chips) 
Seat 8: lantern16 (1804 in chips) 
Seat 9: poony53 (10305 in chips) 
zocker131415: posts the ante 100
DIDISATELITE: posts the ante 100
hzane: posts the ante 100
Mr. Amarelex: posts the ante 100
thgo_zo: posts the ante 100
pocketstuff: posts the ante 100
FDB57: posts the ante 100
lantern16: posts the ante 100
poony53: posts the ante 100
pocketstuff: posts small blind 500
FDB57: posts big blind 1000
*** HOLE CARDS ***
Dealt to hzane [2d As]
lantern16: folds 
poony53: folds 
zocker131415: folds 
DIDISATELITE: folds 
hzane: calls 1000
Mr. Amarelex: calls 1000
thgo_zo: folds 
pocketstuff: folds 
FDB57: checks 
*** FLOP *** [6c Kd 2h]
FDB57: checks 
hzane: bets 1000
Mr. Amarelex: folds 
FDB57: calls 1000
*** TURN *** [6c Kd 2h] [9h]
FDB57: checks 
hzane: bets 3000
FDB57: calls 3000
*** RIVER *** [6c Kd 2h 9h] [8d]
FDB57: checks 
hzane: checks 
*** SHOW DOWN ***
FDB57: shows [Qh 5h] (high card King)
hzane: shows [2d As] (a pair of Deuces)
hzane collected 12400 from pot
*** SUMMARY ***
Total pot 12400 | Rake 0 
Board [6c Kd 2h 9h 8d]
Seat 1: zocker131415 folded before Flop (didn't bet)
Seat 2: DIDISATELITE folded before Flop (didn't bet)
Seat 3: hzane showed [2d As] and won (12400) with a pair of Deuces
Seat 4: Mr. Amarelex folded on the Flop
Seat 5: thgo_zo (button) folded before Flop (didn't bet)
Seat 6: pocketstuff (small blind) folded before Flop
Seat 7: FDB57 (big blind) showed [Qh 5h] and lost with high card King
Seat 8: lantern16 folded before Flop (didn't bet)
Seat 9: poony53 folded before Flop (didn't bet)



PokerStars Hand #189422544466: Tournament #2367584539, 9000+1000 Hold'em No Limit - Level XXIII (500/1000) - 2018/08/01 22:29:10 ET
Table '2367584539 20' 9-max Seat #6 is the button
Seat 1: zocker131415 (8180 in chips) 
Seat 2: DIDISATELITE (2655 in chips) 
Seat 3: hzane (39259 in chips) 
Seat 5: thgo_zo (12568 in chips) 
Seat 6: pocketstuff (8082 in chips) 
Seat 7: FDB57 (11267 in chips) 
Seat 8: lantern16 (1704 in chips) 
Seat 9: poony53 (10205 in chips) 
zocker131415: posts the ante 100
DIDISATELITE: posts the ante 100
hzane: posts the ante 100
thgo_zo: posts the ante 100
pocketstuff: posts the ante 100
FDB57: posts the ante 100
lantern16: posts the ante 100
poony53: posts the ante 100
FDB57: posts small blind 500
lantern16: posts big blind 1000
*** HOLE CARDS ***
Dealt to hzane [Ts 8h]
poony53: folds 
zocker131415: calls 1000
DIDISATELITE: folds 
hzane: folds 
thgo_zo: folds 
pocketstuff: folds 
FDB57: calls 500
lantern16: checks 
*** FLOP *** [Qc 5s Qd]
FDB57: checks 
lantern16: bets 604 and is all-in
zocker131415: calls 604
FDB57: calls 604
*** TURN *** [Qc 5s Qd] [3s]
FDB57: checks 
zocker131415: bets 6476 and is all-in
FDB57: folds 
Uncalled bet (6476) returned to zocker131415
*** RIVER *** [Qc 5s Qd 3s] [6d]
*** SHOW DOWN ***
lantern16: shows [3d Qh] (a full house, Queens full of Threes)
zocker131415: shows [7h 3h] (two pair, Queens and Threes)
lantern16 collected 5612 from pot
*** SUMMARY ***
Total pot 5612 | Rake 0 
Board [Qc 5s Qd 3s 6d]
Seat 1: zocker131415 showed [7h 3h] and lost with two pair, Queens and Threes
Seat 2: DIDISATELITE folded before Flop (didn't bet)
Seat 3: hzane folded before Flop (didn't bet)
Seat 5: thgo_zo folded before Flop (didn't bet)
Seat 6: pocketstuff (button) folded before Flop (didn't bet)
Seat 7: FDB57 (small blind) folded on the Turn
Seat 8: lantern16 (big blind) showed [3d Qh] and won (5612) with a full house, Queens full of Threes
Seat 9: poony53 folded before Flop (didn't bet)



PokerStars Hand #189422556041: Tournament #2367584539, 9000+1000 Hold'em No Limit - Level XXIII (500/1000) - 2018/08/01 22:29:48 ET
Table '2367584539 20' 9-max Seat #7 is the button
Seat 1: zocker131415 (6476 in chips) 
Seat 2: DIDISATELITE (2555 in chips) 
Seat 3: hzane (39159 in chips) 
Seat 5: thgo_zo (12468 in chips) 
Seat 6: pocketstuff (7982 in chips) 
Seat 7: FDB57 (9563 in chips) 
Seat 8: lantern16 (5612 in chips) 
Seat 9: poony53 (10105 in chips) 
zocker131415: posts the ante 100
DIDISATELITE: posts the ante 100
hzane: posts the ante 100
thgo_zo: posts the ante 100
pocketstuff: posts the ante 100
FDB57: posts the ante 100
lantern16: posts the ante 100
poony53: posts the ante 100
lantern16: posts small blind 500
poony53: posts big blind 1000
*** HOLE CARDS ***
Dealt to hzane [Kh Jc]
zocker131415: folds 
DIDISATELITE: folds 
hzane: raises 1000 to 2000
thgo_zo: folds 
pocketstuff: folds 
FDB57: folds 
lantern16: folds 
poony53: raises 8005 to 10005 and is all-in
hzane: folds 
Uncalled bet (8005) returned to poony53
poony53 collected 5300 from pot
*** SUMMARY ***
Total pot 5300 | Rake 0 
Seat 1: zocker131415 folded before Flop (didn't bet)
Seat 2: DIDISATELITE folded before Flop (didn't bet)
Seat 3: hzane folded before Flop
Seat 5: thgo_zo folded before Flop (didn't bet)
Seat 6: pocketstuff folded before Flop (didn't bet)
Seat 7: FDB57 (button) folded before Flop (didn't bet)
Seat 8: lantern16 (small blind) folded before Flop
Seat 9: poony53 (big blind) collected (5300)



PokerStars Hand #189422566457: Tournament #2367584539, 9000+1000 Hold'em No Limit - Level XXIV (600/1200) - 2018/08/01 22:30:23 ET
Table '2367584539 20' 9-max Seat #8 is the button
Seat 1: zocker131415 (6376 in chips) 
Seat 2: DIDISATELITE (2455 in chips) 
Seat 3: hzane (37059 in chips) 
Seat 5: thgo_zo (12368 in chips) 
Seat 6: pocketstuff (7882 in chips) 
Seat 7: FDB57 (9463 in chips) 
Seat 8: lantern16 (5012 in chips) 
Seat 9: poony53 (13305 in chips) 
zocker131415: posts the ante 120
DIDISATELITE: posts the ante 120
hzane: posts the ante 120
thgo_zo: posts the ante 120
pocketstuff: posts the ante 120
FDB57: posts the ante 120
lantern16: posts the ante 120
poony53: posts the ante 120
poony53: posts small blind 600
zocker131415: posts big blind 1200
*** HOLE CARDS ***
Dealt to hzane [8c 3d]
DIDISATELITE: folds 
hzane: folds 
thgo_zo: folds 
pocketstuff: folds 
FDB57: calls 1200
lantern16: folds 
poony53: calls 600
zocker131415: checks 
*** FLOP *** [2h 9d Jc]
poony53: checks 
zocker131415: bets 5056 and is all-in
FDB57: folds 
poony53: folds 
Uncalled bet (5056) returned to zocker131415
zocker131415 collected 4560 from pot
zocker131415: doesn't show hand 
*** SUMMARY ***
Total pot 4560 | Rake 0 
Board [2h 9d Jc]
Seat 1: zocker131415 (big blind) collected (4560)
Seat 2: DIDISATELITE folded before Flop (didn't bet)
Seat 3: hzane folded before Flop (didn't bet)
Seat 5: thgo_zo folded before Flop (didn't bet)
Seat 6: pocketstuff folded before Flop (didn't bet)
Seat 7: FDB57 folded on the Flop
Seat 8: lantern16 (button) folded before Flop (didn't bet)
Seat 9: poony53 (small blind) folded on the Flop



PokerStars Hand #189422574904: Tournament #2367584539, 9000+1000 Hold'em No Limit - Level XXIV (600/1200) - 2018/08/01 22:30:51 ET
Table '2367584539 20' 9-max Seat #9 is the button
Seat 1: zocker131415 (9616 in chips) 
Seat 2: DIDISATELITE (2335 in chips) 
Seat 3: hzane (36939 in chips) 
Seat 5: thgo_zo (12248 in chips) 
Seat 6: pocketstuff (7762 in chips) 
Seat 7: FDB57 (8143 in chips) 
Seat 8: lantern16 (4892 in chips) 
Seat 9: poony53 (11985 in chips) 
zocker131415: posts the ante 120
DIDISATELITE: posts the ante 120
hzane: posts the ante 120
thgo_zo: posts the ante 120
pocketstuff: posts the ante 120
FDB57: posts the ante 120
lantern16: posts the ante 120
poony53: posts the ante 120
zocker131415: posts small blind 600
DIDISATELITE: posts big blind 1200
*** HOLE CARDS ***
Dealt to hzane [5c 9d]
hzane: folds 
thgo_zo: folds 
pocketstuff: folds 
FDB57: calls 1200
lantern16: folds 
poony53: folds 
zocker131415: calls 600
DIDISATELITE: raises 1015 to 2215 and is all-in
FDB57: calls 1015
zocker131415: calls 1015
*** FLOP *** [8s Ah 6d]
zocker131415: checks 
FDB57: bets 1200
zocker131415: calls 1200
*** TURN *** [8s Ah 6d] [6s]
zocker131415: checks 
FDB57: checks 
*** RIVER *** [8s Ah 6d 6s] [8h]
zocker131415: checks 
FDB57: checks 
*** SHOW DOWN ***
zocker131415: shows [7h 5d] (two pair, Eights and Sixes)
FDB57: shows [9c Qc] (two pair, Eights and Sixes)
zocker131415 collected 1200 from side pot
FDB57 collected 1200 from side pot
DIDISATELITE: shows [8d 8c] (four of a kind, Eights)
DIDISATELITE collected 7605 from main pot
*** SUMMARY ***
Total pot 10005 Main pot 7605. Side pot 2400. | Rake 0 
Board [8s Ah 6d 6s 8h]
Seat 1: zocker131415 (small blind) showed [7h 5d] and won (1200) with two pair, Eights and Sixes
Seat 2: DIDISATELITE (big blind) showed [8d 8c] and won (7605) with four of a kind, Eights
Seat 3: hzane folded before Flop (didn't bet)
Seat 5: thgo_zo folded before Flop (didn't bet)
Seat 6: pocketstuff folded before Flop (didn't bet)
Seat 7: FDB57 showed [9c Qc] and won (1200) with two pair, Eights and Sixes
Seat 8: lantern16 folded before Flop (didn't bet)
Seat 9: poony53 (button) folded before Flop (didn't bet)



PokerStars Hand #189422585333: Tournament #2367584539, 9000+1000 Hold'em No Limit - Level XXIV (600/1200) - 2018/08/01 22:31:26 ET
Table '2367584539 20' 9-max Seat #1 is the button
Seat 1: zocker131415 (7281 in chips) 
Seat 2: DIDISATELITE (7605 in chips) 
Seat 3: hzane (36819 in chips) 
Seat 5: thgo_zo (12128 in chips) 
Seat 6: pocketstuff (7642 in chips) 
Seat 7: FDB57 (5808 in chips) 
Seat 8: lantern16 (4772 in chips) 
Seat 9: poony53 (11865 in chips) 
zocker131415: posts the ante 120
DIDISATELITE: posts the ante 120
hzane: posts the ante 120
thgo_zo: posts the ante 120
pocketstuff: posts the ante 120
FDB57: posts the ante 120
lantern16: posts the ante 120
poony53: posts the ante 120
DIDISATELITE: posts small blind 600
hzane: posts big blind 1200
*** HOLE CARDS ***
Dealt to hzane [8h Ad]
thgo_zo: folds 
pocketstuff: folds 
FDB57: folds 
lantern16: folds 
poony53: folds 
zocker131415: calls 1200
DIDISATELITE: calls 600
hzane: checks 
*** FLOP *** [As Qh 8c]
DIDISATELITE: checks 
hzane: bets 1200
zocker131415: raises 4761 to 5961 and is all-in
DIDISATELITE: folds 
hzane: calls 4761
*** TURN *** [As Qh 8c] [7s]
*** RIVER *** [As Qh 8c 7s] [6h]
*** SHOW DOWN ***
hzane: shows [8h Ad] (two pair, Aces and Eights)
zocker131415: shows [8d Ac] (two pair, Aces and Eights)
hzane collected 8241 from pot
zocker131415 collected 8241 from pot
*** SUMMARY ***
Total pot 16482 | Rake 0 
Board [As Qh 8c 7s 6h]
Seat 1: zocker131415 (button) showed [8d Ac] and won (8241) with two pair, Aces and Eights
Seat 2: DIDISATELITE (small blind) folded on the Flop
Seat 3: hzane (big blind) showed [8h Ad] and won (8241) with two pair, Aces and Eights
Seat 5: thgo_zo folded before Flop (didn't bet)
Seat 6: pocketstuff folded before Flop (didn't bet)
Seat 7: FDB57 folded before Flop (didn't bet)
Seat 8: lantern16 folded before Flop (didn't bet)
Seat 9: poony53 folded before Flop (didn't bet)



PokerStars Hand #189422595088: Tournament #2367584539, 9000+1000 Hold'em No Limit - Level XXIV (600/1200) - 2018/08/01 22:31:59 ET
Table '2367584539 20' 9-max Seat #2 is the button
Seat 1: zocker131415 (8241 in chips) 
Seat 2: DIDISATELITE (6285 in chips) 
Seat 3: hzane (37779 in chips) 
Seat 5: thgo_zo (12008 in chips) 
Seat 6: pocketstuff (7522 in chips) 
Seat 7: FDB57 (5688 in chips) 
Seat 8: lantern16 (4652 in chips) 
Seat 9: poony53 (11745 in chips) 
zocker131415: posts the ante 120
DIDISATELITE: posts the ante 120
hzane: posts the ante 120
thgo_zo: posts the ante 120
pocketstuff: posts the ante 120
FDB57: posts the ante 120
lantern16: posts the ante 120
poony53: posts the ante 120
hzane: posts small blind 600
thgo_zo: posts big blind 1200
*** HOLE CARDS ***
Dealt to hzane [4s Th]
pocketstuff: folds 
FDB57: folds 
lantern16: calls 1200
poony53: folds 
zocker131415: folds 
DIDISATELITE: folds 
hzane: folds 
thgo_zo: checks 
*** FLOP *** [5d 7s Qh]
thgo_zo: checks 
lantern16: bets 3332 and is all-in
thgo_zo: folds 
Uncalled bet (3332) returned to lantern16
lantern16 collected 3960 from pot
lantern16: doesn't show hand 
*** SUMMARY ***
Total pot 3960 | Rake 0 
Board [5d 7s Qh]
Seat 1: zocker131415 folded before Flop (didn't bet)
Seat 2: DIDISATELITE (button) folded before Flop (didn't bet)
Seat 3: hzane (small blind) folded before Flop
Seat 5: thgo_zo (big blind) folded on the Flop
Seat 6: pocketstuff folded before Flop (didn't bet)
Seat 7: FDB57 folded before Flop (didn't bet)
Seat 8: lantern16 collected (3960)
Seat 9: poony53 folded before Flop (didn't bet)



PokerStars Hand #189422603514: Tournament #2367584539, 9000+1000 Hold'em No Limit - Level XXIV (600/1200) - 2018/08/01 22:32:28 ET
Table '2367584539 20' 9-max Seat #3 is the button
Seat 1: zocker131415 (8121 in chips) 
Seat 2: DIDISATELITE (6165 in chips) 
Seat 3: hzane (37059 in chips) 
Seat 5: thgo_zo (10688 in chips) 
Seat 6: pocketstuff (7402 in chips) 
Seat 7: FDB57 (5568 in chips) 
Seat 8: lantern16 (7292 in chips) 
Seat 9: poony53 (11625 in chips) 
zocker131415: posts the ante 120
DIDISATELITE: posts the ante 120
hzane: posts the ante 120
thgo_zo: posts the ante 120
pocketstuff: posts the ante 120
FDB57: posts the ante 120
lantern16: posts the ante 120
poony53: posts the ante 120
thgo_zo: posts small blind 600
pocketstuff: posts big blind 1200
*** HOLE CARDS ***
Dealt to hzane [7c 3c]
FDB57: calls 1200
lantern16: folds 
poony53: folds 
zocker131415: calls 1200
DIDISATELITE: folds 
hzane: calls 1200
thgo_zo: folds 
pocketstuff: checks 
*** FLOP *** [4s 3d 7h]
pocketstuff: checks 
FDB57: bets 1200
zocker131415: calls 1200
hzane: calls 1200
pocketstuff: folds 
*** TURN *** [4s 3d 7h] [Jd]
FDB57: bets 1200
zocker131415: raises 4401 to 5601 and is all-in
hzane: calls 5601
FDB57: calls 1848 and is all-in
*** RIVER *** [4s 3d 7h Jd] [9d]
*** SHOW DOWN ***
zocker131415: shows [Jc Qd] (a pair of Jacks)
hzane: shows [7c 3c] (two pair, Sevens and Threes)
hzane collected 5106 from side pot
FDB57: shows [Qh 8s] (high card Queen)
hzane collected 19104 from main pot
zocker131415 finished the tournament in 47th place and received 27000.
FDB57 finished the tournament in 48th place and received 27000.
*** SUMMARY ***
Total pot 24210 Main pot 19104. Side pot 5106. | Rake 0 
Board [4s 3d 7h Jd 9d]
Seat 1: zocker131415 showed [Jc Qd] and lost with a pair of Jacks
Seat 2: DIDISATELITE folded before Flop (didn't bet)
Seat 3: hzane (button) showed [7c 3c] and won (24210) with two pair, Sevens and Threes
Seat 5: thgo_zo (small blind) folded before Flop
Seat 6: pocketstuff (big blind) folded on the Flop
Seat 7: FDB57 showed [Qh 8s] and lost with high card Queen
Seat 8: lantern16 folded before Flop (didn't bet)
Seat 9: poony53 folded before Flop (didn't bet)



PokerStars Hand #189422615766: Tournament #2367584539, 9000+1000 Hold'em No Limit - Level XXIV (600/1200) - 2018/08/01 22:33:09 ET
Table '2367584539 20' 9-max Seat #5 is the button
Seat 2: DIDISATELITE (6045 in chips) 
Seat 3: hzane (53148 in chips) 
Seat 5: thgo_zo (9968 in chips) 
Seat 6: pocketstuff (6082 in chips) 
Seat 8: lantern16 (7172 in chips) 
Seat 9: poony53 (11505 in chips) 
DIDISATELITE: posts the ante 120
hzane: posts the ante 120
thgo_zo: posts the ante 120
pocketstuff: posts the ante 120
lantern16: posts the ante 120
poony53: posts the ante 120
pocketstuff: posts small blind 600
lantern16: posts big blind 1200
*** HOLE CARDS ***
Dealt to hzane [8h 9d]
poony53: folds 
DIDISATELITE: folds 
hzane: folds 
thgo_zo: folds 
pocketstuff: folds 
Uncalled bet (600) returned to lantern16
lantern16 collected 1920 from pot
lantern16: doesn't show hand 
*** SUMMARY ***
Total pot 1920 | Rake 0 
Seat 2: DIDISATELITE folded before Flop (didn't bet)
Seat 3: hzane folded before Flop (didn't bet)
Seat 5: thgo_zo (button) folded before Flop (didn't bet)
Seat 6: pocketstuff (small blind) folded before Flop
Seat 8: lantern16 (big blind) collected (1920)
Seat 9: poony53 folded before Flop (didn't bet)



PokerStars Hand #189422619689: Tournament #2367584539, 9000+1000 Hold'em No Limit - Level XXV (700/1400) - 2018/08/01 22:33:22 ET
Table '2367584539 20' 9-max Seat #6 is the button
Seat 2: DIDISATELITE (5925 in chips) 
Seat 3: hzane (53028 in chips) 
Seat 4: coolercall1 (26447 in chips) 
Seat 5: thgo_zo (9848 in chips) 
Seat 6: pocketstuff (5362 in chips) 
Seat 8: lantern16 (8372 in chips) 
Seat 9: poony53 (11385 in chips) 
DIDISATELITE: posts the ante 140
hzane: posts the ante 140
coolercall1: posts the ante 140
thgo_zo: posts the ante 140
pocketstuff: posts the ante 140
lantern16: posts the ante 140
poony53: posts the ante 140
lantern16: posts small blind 700
poony53: posts big blind 1400
*** HOLE CARDS ***
Dealt to hzane [5h Qd]
DIDISATELITE: calls 1400
hzane: folds 
coolercall1: folds 
thgo_zo: folds 
pocketstuff: folds 
lantern16: calls 700
poony53: checks 
*** FLOP *** [Ad Td 5d]
lantern16: checks 
poony53: checks 
DIDISATELITE: bets 4385 and is all-in
lantern16: folds 
poony53: folds 
Uncalled bet (4385) returned to DIDISATELITE
DIDISATELITE collected 5180 from pot
DIDISATELITE: doesn't show hand 
*** SUMMARY ***
Total pot 5180 | Rake 0 
Board [Ad Td 5d]
Seat 2: DIDISATELITE collected (5180)
Seat 3: hzane folded before Flop (didn't bet)
Seat 4: coolercall1 folded before Flop (didn't bet)
Seat 5: thgo_zo folded before Flop (didn't bet)
Seat 6: pocketstuff (button) folded before Flop (didn't bet)
Seat 8: lantern16 (small blind) folded on the Flop
Seat 9: poony53 (big blind) folded on the Flop



PokerStars Hand #189422628390: Tournament #2367584539, 9000+1000 Hold'em No Limit - Level XXV (700/1400) - 2018/08/01 22:33:52 ET
Table '2367584539 20' 9-max Seat #8 is the button
Seat 1: jeroal (30662 in chips) 
Seat 2: DIDISATELITE (9565 in chips) 
Seat 3: hzane (52888 in chips) 
Seat 4: coolercall1 (26307 in chips) 
Seat 5: thgo_zo (9708 in chips) 
Seat 6: pocketstuff (5222 in chips) 
Seat 7: MmeBreton (14300 in chips) 
Seat 8: lantern16 (6832 in chips) 
Seat 9: poony53 (9845 in chips) 
jeroal: posts the ante 140
DIDISATELITE: posts the ante 140
hzane: posts the ante 140
coolercall1: posts the ante 140
thgo_zo: posts the ante 140
pocketstuff: posts the ante 140
MmeBreton: posts the ante 140
lantern16: posts the ante 140
poony53: posts the ante 140
poony53: posts small blind 700
jeroal: posts big blind 1400
*** HOLE CARDS ***
Dealt to hzane [2d Ks]
DIDISATELITE: folds 
hzane: folds 
coolercall1: folds 
thgo_zo: folds 
pocketstuff: folds 
MmeBreton: folds 
lantern16: folds 
poony53: calls 700
jeroal: checks 
*** FLOP *** [4h Kc Tc]
poony53: bets 1400
jeroal: folds 
Uncalled bet (1400) returned to poony53
poony53 collected 4060 from pot
poony53: doesn't show hand 
*** SUMMARY ***
Total pot 4060 | Rake 0 
Board [4h Kc Tc]
Seat 1: jeroal (big blind) folded on the Flop
Seat 2: DIDISATELITE folded before Flop (didn't bet)
Seat 3: hzane folded before Flop (didn't bet)
Seat 4: coolercall1 folded before Flop (didn't bet)
Seat 5: thgo_zo folded before Flop (didn't bet)
Seat 6: pocketstuff folded before Flop (didn't bet)
Seat 7: MmeBreton folded before Flop (didn't bet)
Seat 8: lantern16 (button) folded before Flop (didn't bet)
Seat 9: poony53 (small blind) collected (4060)



PokerStars Hand #189422639388: Tournament #2367584539, 9000+1000 Hold'em No Limit - Level XXV (700/1400) - 2018/08/01 22:34:29 ET
Table '2367584539 20' 9-max Seat #9 is the button
Seat 1: jeroal (29122 in chips) 
Seat 2: DIDISATELITE (9425 in chips) 
Seat 3: hzane (52748 in chips) 
Seat 4: coolercall1 (26167 in chips) 
Seat 5: thgo_zo (9568 in chips) 
Seat 6: pocketstuff (5082 in chips) 
Seat 7: MmeBreton (14160 in chips) 
Seat 8: lantern16 (6692 in chips) 
Seat 9: poony53 (12365 in chips) 
jeroal: posts the ante 140
DIDISATELITE: posts the ante 140
hzane: posts the ante 140
coolercall1: posts the ante 140
thgo_zo: posts the ante 140
pocketstuff: posts the ante 140
MmeBreton: posts the ante 140
lantern16: posts the ante 140
poony53: posts the ante 140
jeroal: posts small blind 700
DIDISATELITE: posts big blind 1400
*** HOLE CARDS ***
Dealt to hzane [Qc 7h]
hzane: folds 
coolercall1: folds 
thgo_zo: folds 
pocketstuff: folds 
MmeBreton: calls 1400
lantern16: folds 
poony53: calls 1400
jeroal: calls 700
DIDISATELITE: checks 
*** FLOP *** [7s Tc 2h]
jeroal: checks 
DIDISATELITE: checks 
MmeBreton: bets 1400
poony53: folds 
jeroal: folds 
DIDISATELITE: folds 
Uncalled bet (1400) returned to MmeBreton
MmeBreton collected 6860 from pot
MmeBreton: doesn't show hand 
*** SUMMARY ***
Total pot 6860 | Rake 0 
Board [7s Tc 2h]
Seat 1: jeroal (small blind) folded on the Flop
Seat 2: DIDISATELITE (big blind) folded on the Flop
Seat 3: hzane folded before Flop (didn't bet)
Seat 4: coolercall1 folded before Flop (didn't bet)
Seat 5: thgo_zo folded before Flop (didn't bet)
Seat 6: pocketstuff folded before Flop (didn't bet)
Seat 7: MmeBreton collected (6860)
Seat 8: lantern16 folded before Flop (didn't bet)
Seat 9: poony53 (button) folded on the Flop



PokerStars Hand #189422650841: Tournament #2367584539, 9000+1000 Hold'em No Limit - Level XXV (700/1400) - 2018/08/01 22:35:08 ET
Table '2367584539 20' 9-max Seat #1 is the button
Seat 1: jeroal (27582 in chips) 
Seat 2: DIDISATELITE (7885 in chips) 
Seat 3: hzane (52608 in chips) 
Seat 4: coolercall1 (26027 in chips) 
Seat 5: thgo_zo (9428 in chips) 
Seat 6: pocketstuff (4942 in chips) 
Seat 7: MmeBreton (19480 in chips) 
Seat 8: lantern16 (6552 in chips) 
Seat 9: poony53 (10825 in chips) 
jeroal: posts the ante 140
DIDISATELITE: posts the ante 140
hzane: posts the ante 140
coolercall1: posts the ante 140
thgo_zo: posts the ante 140
pocketstuff: posts the ante 140
MmeBreton: posts the ante 140
lantern16: posts the ante 140
poony53: posts the ante 140
DIDISATELITE: posts small blind 700
hzane: posts big blind 1400
*** HOLE CARDS ***
Dealt to hzane [3h 9d]
coolercall1: folds 
thgo_zo: folds 
pocketstuff: folds 
MmeBreton: folds 
lantern16: folds 
poony53: folds 
jeroal: raises 1400 to 2800
DIDISATELITE: calls 2100
hzane: folds 
*** FLOP *** [Qh Kh 2c]
DIDISATELITE: checks 
jeroal: bets 1400
DIDISATELITE: calls 1400
*** TURN *** [Qh Kh 2c] [7s]
DIDISATELITE: checks 
jeroal: bets 1400
DIDISATELITE: folds 
Uncalled bet (1400) returned to jeroal
jeroal collected 11060 from pot
jeroal: doesn't show hand 
*** SUMMARY ***
Total pot 11060 | Rake 0 
Board [Qh Kh 2c 7s]
Seat 1: jeroal (button) collected (11060)
Seat 2: DIDISATELITE (small blind) folded on the Turn
Seat 3: hzane (big blind) folded before Flop
Seat 4: coolercall1 folded before Flop (didn't bet)
Seat 5: thgo_zo folded before Flop (didn't bet)
Seat 6: pocketstuff folded before Flop (didn't bet)
Seat 7: MmeBreton folded before Flop (didn't bet)
Seat 8: lantern16 folded before Flop (didn't bet)
Seat 9: poony53 folded before Flop (didn't bet)



PokerStars Hand #189422661141: Tournament #2367584539, 9000+1000 Hold'em No Limit - Level XXV (700/1400) - 2018/08/01 22:35:44 ET
Table '2367584539 20' 9-max Seat #2 is the button
Seat 1: jeroal (34302 in chips) 
Seat 2: DIDISATELITE (3545 in chips) 
Seat 3: hzane (51068 in chips) 
Seat 4: coolercall1 (25887 in chips) 
Seat 5: thgo_zo (9288 in chips) 
Seat 6: pocketstuff (4802 in chips) 
Seat 7: MmeBreton (19340 in chips) 
Seat 9: poony53 (10685 in chips) 
jeroal: posts the ante 140
DIDISATELITE: posts the ante 140
hzane: posts the ante 140
coolercall1: posts the ante 140
thgo_zo: posts the ante 140
pocketstuff: posts the ante 140
MmeBreton: posts the ante 140
poony53: posts the ante 140
hzane: posts small blind 700
coolercall1: posts big blind 1400
*** HOLE CARDS ***
Dealt to hzane [7d Ac]
thgo_zo: folds 
pocketstuff: folds 
MmeBreton: folds 
poony53: folds 
jeroal: folds 
DIDISATELITE: folds 
hzane: raises 1400 to 2800
coolercall1: calls 1400
*** FLOP *** [Jd 4h 7c]
hzane: bets 1400
coolercall1: raises 2800 to 4200
hzane has timed out
hzane: folds 
Uncalled bet (2800) returned to coolercall1
coolercall1 collected 9520 from pot
coolercall1: doesn't show hand 
*** SUMMARY ***
Total pot 9520 | Rake 0 
Board [Jd 4h 7c]
Seat 1: jeroal folded before Flop (didn't bet)
Seat 2: DIDISATELITE (button) folded before Flop (didn't bet)
Seat 3: hzane (small blind) folded on the Flop
Seat 4: coolercall1 (big blind) collected (9520)
Seat 5: thgo_zo folded before Flop (didn't bet)
Seat 6: pocketstuff folded before Flop (didn't bet)
Seat 7: MmeBreton folded before Flop (didn't bet)
Seat 9: poony53 folded before Flop (didn't bet)



PokerStars Hand #189422676589: Tournament #2367584539, 9000+1000 Hold'em No Limit - Level XXVI (800/1600) - 2018/08/01 22:36:36 ET
Table '2367584539 20' 9-max Seat #3 is the button
Seat 1: jeroal (34162 in chips) 
Seat 2: DIDISATELITE (3405 in chips) 
Seat 3: hzane (46728 in chips) is sitting out
Seat 4: coolercall1 (31067 in chips) 
Seat 5: thgo_zo (9148 in chips) 
Seat 6: pocketstuff (4662 in chips) 
Seat 7: MmeBreton (19200 in chips) 
Seat 9: poony53 (10545 in chips) 
jeroal: posts the ante 160
DIDISATELITE: posts the ante 160
hzane: posts the ante 160
coolercall1: posts the ante 160
thgo_zo: posts the ante 160
pocketstuff: posts the ante 160
MmeBreton: posts the ante 160
poony53: posts the ante 160
coolercall1: posts small blind 800
thgo_zo: posts big blind 1600
*** HOLE CARDS ***
Dealt to hzane [Qd Js]
pocketstuff: folds 
MmeBreton has timed out
MmeBreton: folds 
poony53: folds 
jeroal: calls 1600
DIDISATELITE: folds 
hzane: calls 1600
coolercall1: calls 800
thgo_zo: checks 
*** FLOP *** [2s 2h 6s]
coolercall1: checks 
thgo_zo: checks 
jeroal: checks 
hzane: bets 1600
coolercall1: folds 
thgo_zo: folds 
jeroal: folds 
Uncalled bet (1600) returned to hzane
hzane collected 7680 from pot
*** SUMMARY ***
Total pot 7680 | Rake 0 
Board [2s 2h 6s]
Seat 1: jeroal folded on the Flop
Seat 2: DIDISATELITE folded before Flop (didn't bet)
Seat 3: hzane (button) collected (7680)
Seat 4: coolercall1 (small blind) folded on the Flop
Seat 5: thgo_zo (big blind) folded on the Flop
Seat 6: pocketstuff folded before Flop (didn't bet)
Seat 7: MmeBreton folded before Flop (didn't bet)
Seat 9: poony53 folded before Flop (didn't bet)



PokerStars Hand #189422689688: Tournament #2367584539, 9000+1000 Hold'em No Limit - Level XXVI (800/1600) - 2018/08/01 22:37:22 ET
Table '2367584539 20' 9-max Seat #4 is the button
Seat 1: jeroal (32402 in chips) 
Seat 2: DIDISATELITE (3245 in chips) 
Seat 3: hzane (52648 in chips) 
Seat 4: coolercall1 (29307 in chips) 
Seat 5: thgo_zo (7388 in chips) 
Seat 6: pocketstuff (4502 in chips) 
Seat 7: MmeBreton (19040 in chips) 
Seat 9: poony53 (10385 in chips) 
jeroal: posts the ante 160
DIDISATELITE: posts the ante 160
hzane: posts the ante 160
coolercall1: posts the ante 160
thgo_zo: posts the ante 160
pocketstuff: posts the ante 160
MmeBreton: posts the ante 160
poony53: posts the ante 160
thgo_zo: posts small blind 800
pocketstuff: posts big blind 1600
*** HOLE CARDS ***
Dealt to hzane [Qc Ac]
MmeBreton: folds 
poony53: folds 
jeroal: folds 
DIDISATELITE: folds 
hzane: raises 1600 to 3200
coolercall1: folds 
thgo_zo: raises 1600 to 4800
pocketstuff: calls 2742 and is all-in
hzane: raises 1600 to 6400
thgo_zo: raises 828 to 7228 and is all-in
hzane: calls 828
*** FLOP *** [As Js Th]
*** TURN *** [As Js Th] [7s]
*** RIVER *** [As Js Th 7s] [2h]
*** SHOW DOWN ***
thgo_zo: shows [Kd Ks] (a pair of Kings)
hzane: shows [Qc Ac] (a pair of Aces)
hzane collected 5772 from side pot
pocketstuff: shows [9d 9h] (a pair of Nines)
hzane collected 14306 from main pot
thgo_zo finished the tournament in 36th place and received 33000.
pocketstuff finished the tournament in 37th place and received 30000.
*** SUMMARY ***
Total pot 20078 Main pot 14306. Side pot 5772. | Rake 0 
Board [As Js Th 7s 2h]
Seat 1: jeroal folded before Flop (didn't bet)
Seat 2: DIDISATELITE folded before Flop (didn't bet)
Seat 3: hzane showed [Qc Ac] and won (20078) with a pair of Aces
Seat 4: coolercall1 (button) folded before Flop (didn't bet)
Seat 5: thgo_zo (small blind) showed [Kd Ks] and lost with a pair of Kings
Seat 6: pocketstuff (big blind) showed [9d 9h] and lost with a pair of Nines
Seat 7: MmeBreton folded before Flop (didn't bet)
Seat 9: poony53 folded before Flop (didn't bet)



PokerStars Hand #189422713203: Tournament #2367584539, 9000+1000 Hold'em No Limit - Level XXVI (800/1600) - 2018/08/01 22:38:43 ET
Table '2367584539 35' 9-max Seat #1 is the button
Seat 1: MrBrat2u (19934 in chips) 
Seat 3: tboymyalias (23981 in chips) 
Seat 4: pupunovich (16834 in chips) 
Seat 5: konakiki (24698 in chips) 
Seat 6: kamane123 (18783 in chips) is sitting out
Seat 7: DIDISATELITE (3085 in chips) 
Seat 8: DR SOONNE (8328 in chips) 
Seat 9: hzane (65338 in chips) 
MrBrat2u: posts the ante 160
tboymyalias: posts the ante 160
pupunovich: posts the ante 160
konakiki: posts the ante 160
kamane123: posts the ante 160
DIDISATELITE: posts the ante 160
DR SOONNE: posts the ante 160
hzane: posts the ante 160
tboymyalias: posts small blind 800
pupunovich: posts big blind 1600
*** HOLE CARDS ***
Dealt to hzane [Qs Ah]
konakiki: folds 
kamane123: folds 
DIDISATELITE: folds 
DR SOONNE: folds 
hzane: raises 1600 to 3200
MrBrat2u: folds 
tboymyalias: folds 
pupunovich: calls 1600
*** FLOP *** [Td Ad 6c]
pupunovich: checks 
hzane: bets 1600
pupunovich: calls 1600
*** TURN *** [Td Ad 6c] [5d]
pupunovich: bets 9578
hzane: raises 9578 to 19156
pupunovich: calls 2296 and is all-in
Uncalled bet (7282) returned to hzane
*** RIVER *** [Td Ad 6c 5d] [8c]
*** SHOW DOWN ***
pupunovich: shows [Tc Jc] (a pair of Tens)
hzane: shows [Qs Ah] (a pair of Aces)
hzane collected 35428 from pot
pupunovich finished the tournament in 31st place and received 33000.
*** SUMMARY ***
Total pot 35428 | Rake 0 
Board [Td Ad 6c 5d 8c]
Seat 1: MrBrat2u (button) folded before Flop (didn't bet)
Seat 3: tboymyalias (small blind) folded before Flop
Seat 4: pupunovich (big blind) showed [Tc Jc] and lost with a pair of Tens
Seat 5: konakiki folded before Flop (didn't bet)
Seat 6: kamane123 folded before Flop (didn't bet)
Seat 7: DIDISATELITE folded before Flop (didn't bet)
Seat 8: DR SOONNE folded before Flop (didn't bet)
Seat 9: hzane showed [Qs Ah] and won (35428) with a pair of Aces



PokerStars Hand #189422725462: Tournament #2367584539, 9000+1000 Hold'em No Limit - Level XXVII (1000/2000) - 2018/08/01 22:39:26 ET
Table '2367584539 35' 9-max Seat #3 is the button
Seat 1: MrBrat2u (19774 in chips) 
Seat 2: coolercall1 (29147 in chips) 
Seat 3: tboymyalias (23021 in chips) 
Seat 5: konakiki (24538 in chips) 
Seat 6: kamane123 (18623 in chips) 
Seat 7: DIDISATELITE (2925 in chips) 
Seat 8: DR SOONNE (8168 in chips) 
Seat 9: hzane (83932 in chips) 
MrBrat2u: posts the ante 200
coolercall1: posts the ante 200
tboymyalias: posts the ante 200
konakiki: posts the ante 200
kamane123: posts the ante 200
DIDISATELITE: posts the ante 200
DR SOONNE: posts the ante 200
hzane: posts the ante 200
konakiki: posts small blind 1000
kamane123: posts big blind 2000
*** HOLE CARDS ***
Dealt to hzane [Kc 6h]
DIDISATELITE: folds 
DR SOONNE: folds 
hzane: folds 
MrBrat2u: calls 2000
coolercall1: folds 
tboymyalias: folds 
konakiki: folds 
kamane123: checks 
*** FLOP *** [4s 6c Jc]
kamane123: bets 2000
MrBrat2u: calls 2000
*** TURN *** [4s 6c Jc] [Qc]
kamane123: bets 6000
MrBrat2u: calls 6000
*** RIVER *** [4s 6c Jc Qc] [Th]
kamane123: bets 4000
MrBrat2u: calls 4000
*** SHOW DOWN ***
kamane123: shows [6d 4c] (two pair, Sixes and Fours)
MrBrat2u: mucks hand 
kamane123 collected 30600 from pot
*** SUMMARY ***
Total pot 30600 | Rake 0 
Board [4s 6c Jc Qc Th]
Seat 1: MrBrat2u mucked [9h Jh]
Seat 2: coolercall1 folded before Flop (didn't bet)
Seat 3: tboymyalias (button) folded before Flop (didn't bet)
Seat 5: konakiki (small blind) folded before Flop
Seat 6: kamane123 (big blind) showed [6d 4c] and won (30600) with two pair, Sixes and Fours
Seat 7: DIDISATELITE folded before Flop (didn't bet)
Seat 8: DR SOONNE folded before Flop (didn't bet)
Seat 9: hzane folded before Flop (didn't bet)



PokerStars Hand #189422747439: Tournament #2367584539, 9000+1000 Hold'em No Limit - Level XXVII (1000/2000) - 2018/08/01 22:40:26 ET
Table '2367584539 35' 9-max Seat #5 is the button
Seat 2: coolercall1 (28947 in chips) 
Seat 3: tboymyalias (22821 in chips) 
Seat 5: konakiki (23338 in chips) 
Seat 6: kamane123 (35023 in chips) 
Seat 7: DIDISATELITE (2725 in chips) 
Seat 8: DR SOONNE (7968 in chips) 
Seat 9: hzane (83732 in chips) 
coolercall1: posts the ante 200
tboymyalias: posts the ante 200
konakiki: posts the ante 200
kamane123: posts the ante 200
DIDISATELITE: posts the ante 200
DR SOONNE: posts the ante 200
hzane: posts the ante 200
kamane123: posts small blind 1000
DIDISATELITE: posts big blind 2000
*** HOLE CARDS ***
Dealt to hzane [4h 7c]
DR SOONNE: folds 
hzane: folds 
coolercall1: raises 6000 to 8000
tboymyalias: folds 
konakiki: folds 
kamane123: folds 
DIDISATELITE: calls 525 and is all-in
Uncalled bet (5475) returned to coolercall1
*** FLOP *** [8s Kd 5d]
*** TURN *** [8s Kd 5d] [Tc]
*** RIVER *** [8s Kd 5d Tc] [Kh]
*** SHOW DOWN ***
DIDISATELITE: shows [Ts Ks] (a full house, Kings full of Tens)
coolercall1: shows [7h Qc] (a pair of Kings)
DIDISATELITE collected 7450 from pot
*** SUMMARY ***
Total pot 7450 | Rake 0 
Board [8s Kd 5d Tc Kh]
Seat 2: coolercall1 showed [7h Qc] and lost with a pair of Kings
Seat 3: tboymyalias folded before Flop (didn't bet)
Seat 5: konakiki (button) folded before Flop (didn't bet)
Seat 6: kamane123 (small blind) folded before Flop
Seat 7: DIDISATELITE (big blind) showed [Ts Ks] and won (7450) with a full house, Kings full of Tens
Seat 8: DR SOONNE folded before Flop (didn't bet)
Seat 9: hzane folded before Flop (didn't bet)



PokerStars Hand #189422757270: Tournament #2367584539, 9000+1000 Hold'em No Limit - Level XXVII (1000/2000) - 2018/08/01 22:41:01 ET
Table '2367584539 35' 9-max Seat #6 is the button
Seat 1: Viceroy1962 (48454 in chips) 
Seat 2: coolercall1 (26222 in chips) 
Seat 3: tboymyalias (22621 in chips) 
Seat 4: Billera (4668 in chips) 
Seat 5: konakiki (23138 in chips) 
Seat 6: kamane123 (33823 in chips) 
Seat 7: DIDISATELITE (7450 in chips) 
Seat 8: DR SOONNE (7768 in chips) 
Seat 9: hzane (83532 in chips) 
Viceroy1962: posts the ante 200
coolercall1: posts the ante 200
tboymyalias: posts the ante 200
Billera: posts the ante 200
konakiki: posts the ante 200
kamane123: posts the ante 200
DIDISATELITE: posts the ante 200
DR SOONNE: posts the ante 200
hzane: posts the ante 200
DIDISATELITE: posts small blind 1000
DR SOONNE: posts big blind 2000
*** HOLE CARDS ***
Dealt to hzane [3s As]
hzane: calls 2000
Viceroy1962: folds 
coolercall1: raises 4000 to 6000
tboymyalias: folds 
Billera: folds 
konakiki: folds 
kamane123: folds 
DIDISATELITE: folds 
DR SOONNE: folds 
hzane: calls 4000
*** FLOP *** [3d 7h Qd]
hzane: bets 2000
coolercall1: raises 18022 to 20022 and is all-in
hzane: folds 
Uncalled bet (18022) returned to coolercall1
coolercall1 collected 20800 from pot
*** SUMMARY ***
Total pot 20800 | Rake 0 
Board [3d 7h Qd]
Seat 1: Viceroy1962 folded before Flop (didn't bet)
Seat 2: coolercall1 collected (20800)
Seat 3: tboymyalias folded before Flop (didn't bet)
Seat 4: Billera folded before Flop (didn't bet)
Seat 5: konakiki folded before Flop (didn't bet)
Seat 6: kamane123 (button) folded before Flop (didn't bet)
Seat 7: DIDISATELITE (small blind) folded before Flop
Seat 8: DR SOONNE (big blind) folded before Flop
Seat 9: hzane folded on the Flop



PokerStars Hand #189422768755: Tournament #2367584539, 9000+1000 Hold'em No Limit - Level XXVII (1000/2000) - 2018/08/01 22:41:42 ET
Table '2367584539 35' 9-max Seat #7 is the button
Seat 1: Viceroy1962 (48254 in chips) 
Seat 2: coolercall1 (38822 in chips) 
Seat 3: tboymyalias (22421 in chips) 
Seat 4: Billera (4468 in chips) 
Seat 5: konakiki (22938 in chips) 
Seat 6: kamane123 (33623 in chips) 
Seat 7: DIDISATELITE (6250 in chips) 
Seat 8: DR SOONNE (5568 in chips) 
Seat 9: hzane (75332 in chips) 
Viceroy1962: posts the ante 200
coolercall1: posts the ante 200
tboymyalias: posts the ante 200
Billera: posts the ante 200
konakiki: posts the ante 200
kamane123: posts the ante 200
DIDISATELITE: posts the ante 200
DR SOONNE: posts the ante 200
hzane: posts the ante 200
DR SOONNE: posts small blind 1000
hzane: posts big blind 2000
*** HOLE CARDS ***
Dealt to hzane [9s Qs]
Viceroy1962: folds 
coolercall1: raises 4000 to 6000
tboymyalias: folds 
Billera: folds 
konakiki: folds 
kamane123: folds 
DIDISATELITE: folds 
DR SOONNE: folds 
hzane: calls 4000
*** FLOP *** [9d Tc 5c]
hzane: checks 
coolercall1: bets 7400
hzane: folds 
Uncalled bet (7400) returned to coolercall1
coolercall1 collected 14800 from pot
coolercall1: doesn't show hand 
*** SUMMARY ***
Total pot 14800 | Rake 0 
Board [9d Tc 5c]
Seat 1: Viceroy1962 folded before Flop (didn't bet)
Seat 2: coolercall1 collected (14800)
Seat 3: tboymyalias folded before Flop (didn't bet)
Seat 4: Billera folded before Flop (didn't bet)
Seat 5: konakiki folded before Flop (didn't bet)
Seat 6: kamane123 folded before Flop (didn't bet)
Seat 7: DIDISATELITE (button) folded before Flop (didn't bet)
Seat 8: DR SOONNE (small blind) folded before Flop
Seat 9: hzane (big blind) folded on the Flop



PokerStars Hand #189422783455: Tournament #2367584539, 9000+1000 Hold'em No Limit - Level XXVIII (1200/2400) - 2018/08/01 22:42:33 ET
Table '2367584539 35' 9-max Seat #8 is the button
Seat 1: Viceroy1962 (48054 in chips) 
Seat 2: coolercall1 (47422 in chips) 
Seat 3: tboymyalias (22221 in chips) 
Seat 4: Billera (4268 in chips) 
Seat 5: konakiki (22738 in chips) 
Seat 6: kamane123 (33423 in chips) 
Seat 7: DIDISATELITE (6050 in chips) 
Seat 8: DR SOONNE (4368 in chips) 
Seat 9: hzane (69132 in chips) 
Viceroy1962: posts the ante 240
coolercall1: posts the ante 240
tboymyalias: posts the ante 240
Billera: posts the ante 240
konakiki: posts the ante 240
kamane123: posts the ante 240
DIDISATELITE: posts the ante 240
DR SOONNE: posts the ante 240
hzane: posts the ante 240
hzane: posts small blind 1200
Viceroy1962: posts big blind 2400
*** HOLE CARDS ***
Dealt to hzane [Jd 5c]
coolercall1: calls 2400
tboymyalias: folds 
Billera: folds 
konakiki: folds 
kamane123: raises 4800 to 7200
DIDISATELITE: folds 
DR SOONNE: calls 4128 and is all-in
hzane: folds 
Viceroy1962: folds 
coolercall1: folds 
Uncalled bet (3072) returned to kamane123
*** FLOP *** [Ts 9d Js]
*** TURN *** [Ts 9d Js] [3c]
*** RIVER *** [Ts 9d Js 3c] [7h]
*** SHOW DOWN ***
kamane123: shows [Qd Qc] (a pair of Queens)
DR SOONNE: shows [Jh Kh] (a pair of Jacks)
kamane123 collected 16416 from pot
DR SOONNE finished the tournament in 27th place and received 37000.
*** SUMMARY ***
Total pot 16416 | Rake 0 
Board [Ts 9d Js 3c 7h]
Seat 1: Viceroy1962 (big blind) folded before Flop
Seat 2: coolercall1 folded before Flop
Seat 3: tboymyalias folded before Flop (didn't bet)
Seat 4: Billera folded before Flop (didn't bet)
Seat 5: konakiki folded before Flop (didn't bet)
Seat 6: kamane123 showed [Qd Qc] and won (16416) with a pair of Queens
Seat 7: DIDISATELITE folded before Flop (didn't bet)
Seat 8: DR SOONNE (button) showed [Jh Kh] and lost with a pair of Jacks
Seat 9: hzane (small blind) folded before Flop



PokerStars Hand #189422793145: Tournament #2367584539, 9000+1000 Hold'em No Limit - Level XXVIII (1200/2400) - 2018/08/01 22:43:08 ET
Table '2367584539 35' 9-max Seat #9 is the button
Seat 1: Viceroy1962 (45414 in chips) 
Seat 2: coolercall1 (44782 in chips) 
Seat 3: tboymyalias (21981 in chips) 
Seat 4: Billera (4028 in chips) 
Seat 5: konakiki (22498 in chips) 
Seat 6: kamane123 (45471 in chips) 
Seat 7: DIDISATELITE (5810 in chips) 
Seat 9: hzane (67692 in chips) 
Viceroy1962: posts the ante 240
coolercall1: posts the ante 240
tboymyalias: posts the ante 240
Billera: posts the ante 240
konakiki: posts the ante 240
kamane123: posts the ante 240
DIDISATELITE: posts the ante 240
hzane: posts the ante 240
Viceroy1962: posts small blind 1200
coolercall1: posts big blind 2400
*** HOLE CARDS ***
Dealt to hzane [2h 8h]
tboymyalias: folds 
Billera: folds 
konakiki: folds 
kamane123: calls 2400
DIDISATELITE: folds 
hzane: folds 
Viceroy1962: folds 
coolercall1: checks 
*** FLOP *** [6c 8s Qd]
coolercall1: bets 4800
kamane123: raises 7200 to 12000
coolercall1: folds 
Uncalled bet (7200) returned to kamane123
kamane123 collected 17520 from pot
kamane123: doesn't show hand 
*** SUMMARY ***
Total pot 17520 | Rake 0 
Board [6c 8s Qd]
Seat 1: Viceroy1962 (small blind) folded before Flop
Seat 2: coolercall1 (big blind) folded on the Flop
Seat 3: tboymyalias folded before Flop (didn't bet)
Seat 4: Billera folded before Flop (didn't bet)
Seat 5: konakiki folded before Flop (didn't bet)
Seat 6: kamane123 collected (17520)
Seat 7: DIDISATELITE folded before Flop (didn't bet)
Seat 9: hzane (button) folded before Flop (didn't bet)



PokerStars Hand #189422801590: Tournament #2367584539, 9000+1000 Hold'em No Limit - Level XXVIII (1200/2400) - 2018/08/01 22:43:37 ET
Table '2367584539 35' 9-max Seat #1 is the button
Seat 1: Viceroy1962 (43974 in chips) 
Seat 2: coolercall1 (37342 in chips) 
Seat 3: tboymyalias (21741 in chips) 
Seat 4: Billera (3788 in chips) 
Seat 5: konakiki (22258 in chips) 
Seat 6: kamane123 (55551 in chips) 
Seat 7: DIDISATELITE (5570 in chips) 
Seat 9: hzane (67452 in chips) 
Viceroy1962: posts the ante 240
coolercall1: posts the ante 240
tboymyalias: posts the ante 240
Billera: posts the ante 240
konakiki: posts the ante 240
kamane123: posts the ante 240
DIDISATELITE: posts the ante 240
hzane: posts the ante 240
coolercall1: posts small blind 1200
tboymyalias: posts big blind 2400
*** HOLE CARDS ***
Dealt to hzane [9s Ks]
Billera: folds 
konakiki: folds 
kamane123: calls 2400
DIDISATELITE: folds 
hzane: calls 2400
Viceroy1962: folds 
coolercall1: calls 1200
tboymyalias: checks 
*** FLOP *** [3d Kh 6s]
coolercall1: checks 
tboymyalias: checks 
kamane123: checks 
hzane: bets 4800
coolercall1: folds 
tboymyalias: folds 
kamane123: folds 
Uncalled bet (4800) returned to hzane
hzane collected 11520 from pot
*** SUMMARY ***
Total pot 11520 | Rake 0 
Board [3d Kh 6s]
Seat 1: Viceroy1962 (button) folded before Flop (didn't bet)
Seat 2: coolercall1 (small blind) folded on the Flop
Seat 3: tboymyalias (big blind) folded on the Flop
Seat 4: Billera folded before Flop (didn't bet)
Seat 5: konakiki folded before Flop (didn't bet)
Seat 6: kamane123 folded on the Flop
Seat 7: DIDISATELITE folded before Flop (didn't bet)
Seat 9: hzane collected (11520)



PokerStars Hand #189422817737: Tournament #2367584539, 9000+1000 Hold'em No Limit - Level XXVIII (1200/2400) - 2018/08/01 22:44:34 ET
Table '2367584539 35' 9-max Seat #2 is the button
Seat 1: Viceroy1962 (43734 in chips) 
Seat 2: coolercall1 (34702 in chips) 
Seat 3: tboymyalias (19101 in chips) 
Seat 4: Billera (3548 in chips) 
Seat 5: konakiki (22018 in chips) 
Seat 6: kamane123 (52911 in chips) 
Seat 7: DIDISATELITE (5330 in chips) 
Seat 9: hzane (76332 in chips) 
Viceroy1962: posts the ante 240
coolercall1: posts the ante 240
tboymyalias: posts the ante 240
Billera: posts the ante 240
konakiki: posts the ante 240
kamane123: posts the ante 240
DIDISATELITE: posts the ante 240
hzane: posts the ante 240
tboymyalias: posts small blind 1200
Billera: posts big blind 2400
*** HOLE CARDS ***
Dealt to hzane [As 3c]
konakiki: folds 
kamane123: folds 
DIDISATELITE: folds 
hzane: calls 2400
Viceroy1962: folds 
coolercall1: folds 
tboymyalias: folds 
Billera: raises 908 to 3308 and is all-in
hzane: calls 908
*** FLOP *** [9d 2s Qd]
*** TURN *** [9d 2s Qd] [Jd]
*** RIVER *** [9d 2s Qd Jd] [Jh]
*** SHOW DOWN ***
Billera: shows [4c 6d] (a pair of Jacks)
hzane: shows [As 3c] (a pair of Jacks - Ace kicker)
hzane collected 9736 from pot
Billera finished the tournament in 23rd place and received 37000.
*** SUMMARY ***
Total pot 9736 | Rake 0 
Board [9d 2s Qd Jd Jh]
Seat 1: Viceroy1962 folded before Flop (didn't bet)
Seat 2: coolercall1 (button) folded before Flop (didn't bet)
Seat 3: tboymyalias (small blind) folded before Flop
Seat 4: Billera (big blind) showed [4c 6d] and lost with a pair of Jacks
Seat 5: konakiki folded before Flop (didn't bet)
Seat 6: kamane123 folded before Flop (didn't bet)
Seat 7: DIDISATELITE folded before Flop (didn't bet)
Seat 9: hzane showed [As 3c] and won (9736) with a pair of Jacks



PokerStars Hand #189422832062: Tournament #2367584539, 9000+1000 Hold'em No Limit - Level XXIX (1400/2800) - 2018/08/01 22:45:25 ET
Table '2367584539 35' 9-max Seat #3 is the button
Seat 1: Viceroy1962 (43494 in chips) 
Seat 2: coolercall1 (34462 in chips) 
Seat 3: tboymyalias (17661 in chips) 
Seat 5: konakiki (21778 in chips) 
Seat 6: kamane123 (52671 in chips) 
Seat 7: DIDISATELITE (5090 in chips) 
Seat 9: hzane (82520 in chips) 
Viceroy1962: posts the ante 280
coolercall1: posts the ante 280
tboymyalias: posts the ante 280
konakiki: posts the ante 280
kamane123: posts the ante 280
DIDISATELITE: posts the ante 280
hzane: posts the ante 280
konakiki: posts small blind 1400
kamane123: posts big blind 2800
*** HOLE CARDS ***
Dealt to hzane [9c 9d]
DIDISATELITE: folds 
hzane: raises 2800 to 5600
Viceroy1962: folds 
coolercall1: folds 
tboymyalias: folds 
konakiki: folds 
kamane123: calls 2800
*** FLOP *** [Js 5c 5s]
kamane123: bets 2800
hzane: raises 2800 to 5600
kamane123: calls 2800
*** TURN *** [Js 5c 5s] [4d]
kamane123: bets 5600
hzane: calls 5600
*** RIVER *** [Js 5c 5s 4d] [Jh]
kamane123: bets 5600
hzane: calls 5600
*** SHOW DOWN ***
kamane123: shows [Ah 3c] (two pair, Jacks and Fives)
hzane: shows [9c 9d] (two pair, Jacks and Nines)
hzane collected 48160 from pot
*** SUMMARY ***
Total pot 48160 | Rake 0 
Board [Js 5c 5s 4d Jh]
Seat 1: Viceroy1962 folded before Flop (didn't bet)
Seat 2: coolercall1 folded before Flop (didn't bet)
Seat 3: tboymyalias (button) folded before Flop (didn't bet)
Seat 5: konakiki (small blind) folded before Flop
Seat 6: kamane123 (big blind) showed [Ah 3c] and lost with two pair, Jacks and Fives
Seat 7: DIDISATELITE folded before Flop (didn't bet)
Seat 9: hzane showed [9c 9d] and won (48160) with two pair, Jacks and Nines



PokerStars Hand #189422846709: Tournament #2367584539, 9000+1000 Hold'em No Limit - Level XXIX (1400/2800) - 2018/08/01 22:46:17 ET
Table '2367584539 35' 9-max Seat #5 is the button
Seat 1: Viceroy1962 (43214 in chips) 
Seat 2: coolercall1 (34182 in chips) 
Seat 3: tboymyalias (17381 in chips) 
Seat 5: konakiki (20098 in chips) 
Seat 6: kamane123 (29991 in chips) 
Seat 7: DIDISATELITE (4810 in chips) 
Seat 9: hzane (108000 in chips) 
Viceroy1962: posts the ante 280
coolercall1: posts the ante 280
tboymyalias: posts the ante 280
konakiki: posts the ante 280
kamane123: posts the ante 280
DIDISATELITE: posts the ante 280
hzane: posts the ante 280
kamane123: posts small blind 1400
DIDISATELITE: posts big blind 2800
*** HOLE CARDS ***
Dealt to hzane [8c 3h]
hzane: folds 
Viceroy1962: folds 
coolercall1: raises 5600 to 8400
tboymyalias: folds 
konakiki: folds 
kamane123: folds 
DIDISATELITE: folds 
Uncalled bet (5600) returned to coolercall1
coolercall1 collected 8960 from pot
*** SUMMARY ***
Total pot 8960 | Rake 0 
Seat 1: Viceroy1962 folded before Flop (didn't bet)
Seat 2: coolercall1 collected (8960)
Seat 3: tboymyalias folded before Flop (didn't bet)
Seat 5: konakiki (button) folded before Flop (didn't bet)
Seat 6: kamane123 (small blind) folded before Flop
Seat 7: DIDISATELITE (big blind) folded before Flop
Seat 9: hzane folded before Flop (didn't bet)



PokerStars Hand #189422850678: Tournament #2367584539, 9000+1000 Hold'em No Limit - Level XXIX (1400/2800) - 2018/08/01 22:46:31 ET
Table '2367584539 35' 9-max Seat #6 is the button
Seat 1: Viceroy1962 (42934 in chips) 
Seat 2: coolercall1 (40062 in chips) 
Seat 3: tboymyalias (17101 in chips) 
Seat 5: konakiki (19818 in chips) 
Seat 6: kamane123 (28311 in chips) 
Seat 7: DIDISATELITE (1730 in chips) 
Seat 9: hzane (107720 in chips) 
Viceroy1962: posts the ante 280
coolercall1: posts the ante 280
tboymyalias: posts the ante 280
konakiki: posts the ante 280
kamane123: posts the ante 280
DIDISATELITE: posts the ante 280
hzane: posts the ante 280
DIDISATELITE: posts small blind 1400
hzane: posts big blind 2800
*** HOLE CARDS ***
Dealt to hzane [Jh 6h]
Viceroy1962: folds 
coolercall1: folds 
tboymyalias: folds 
konakiki: folds 
kamane123: folds 
DIDISATELITE: calls 50 and is all-in
Uncalled bet (1350) returned to hzane
*** FLOP *** [Jd 3s 4c]
*** TURN *** [Jd 3s 4c] [4h]
*** RIVER *** [Jd 3s 4c 4h] [2h]
*** SHOW DOWN ***
DIDISATELITE: shows [Kc 2s] (two pair, Fours and Deuces)
hzane: shows [Jh 6h] (two pair, Jacks and Fours)
hzane collected 4860 from pot
DIDISATELITE finished the tournament in 22nd place and received 37000.
*** SUMMARY ***
Total pot 4860 | Rake 0 
Board [Jd 3s 4c 4h 2h]
Seat 1: Viceroy1962 folded before Flop (didn't bet)
Seat 2: coolercall1 folded before Flop (didn't bet)
Seat 3: tboymyalias folded before Flop (didn't bet)
Seat 5: konakiki folded before Flop (didn't bet)
Seat 6: kamane123 (button) folded before Flop (didn't bet)
Seat 7: DIDISATELITE (small blind) showed [Kc 2s] and lost with two pair, Fours and Deuces
Seat 9: hzane (big blind) showed [Jh 6h] and won (4860) with two pair, Jacks and Fours



PokerStars Hand #189422856108: Tournament #2367584539, 9000+1000 Hold'em No Limit - Level XXIX (1400/2800) - 2018/08/01 22:46:50 ET
Table '2367584539 35' 9-max Seat #9 is the button
Seat 1: Viceroy1962 (42654 in chips) 
Seat 2: coolercall1 (39782 in chips) 
Seat 3: tboymyalias (16821 in chips) 
Seat 5: konakiki (19538 in chips) 
Seat 6: kamane123 (28031 in chips) 
Seat 9: hzane (110850 in chips) 
Viceroy1962: posts the ante 280
coolercall1: posts the ante 280
tboymyalias: posts the ante 280
konakiki: posts the ante 280
kamane123: posts the ante 280
hzane: posts the ante 280
Viceroy1962: posts small blind 1400
coolercall1: posts big blind 2800
*** HOLE CARDS ***
Dealt to hzane [4c Js]
tboymyalias: folds 
konakiki: folds 
kamane123: folds 
hzane: folds 
Viceroy1962: folds 
Uncalled bet (1400) returned to coolercall1
coolercall1 collected 4480 from pot
*** SUMMARY ***
Total pot 4480 | Rake 0 
Seat 1: Viceroy1962 (small blind) folded before Flop
Seat 2: coolercall1 (big blind) collected (4480)
Seat 3: tboymyalias folded before Flop (didn't bet)
Seat 5: konakiki folded before Flop (didn't bet)
Seat 6: kamane123 folded before Flop (didn't bet)
Seat 9: hzane (button) folded before Flop (didn't bet)



PokerStars Hand #189422859364: Tournament #2367584539, 9000+1000 Hold'em No Limit - Level XXIX (1400/2800) - 2018/08/01 22:47:02 ET
Table '2367584539 35' 9-max Seat #1 is the button
Seat 1: Viceroy1962 (40974 in chips) 
Seat 2: coolercall1 (42582 in chips) 
Seat 3: tboymyalias (16541 in chips) 
Seat 5: konakiki (19258 in chips) 
Seat 6: kamane123 (27751 in chips) 
Seat 9: hzane (110570 in chips) 
Viceroy1962: posts the ante 280
coolercall1: posts the ante 280
tboymyalias: posts the ante 280
konakiki: posts the ante 280
kamane123: posts the ante 280
hzane: posts the ante 280
coolercall1: posts small blind 1400
tboymyalias: posts big blind 2800
*** HOLE CARDS ***
Dealt to hzane [Ts 8d]
konakiki: folds 
kamane123: folds 
hzane: folds 
Viceroy1962: folds 
coolercall1: raises 5600 to 8400
tboymyalias: folds 
Uncalled bet (5600) returned to coolercall1
coolercall1 collected 7280 from pot
*** SUMMARY ***
Total pot 7280 | Rake 0 
Seat 1: Viceroy1962 (button) folded before Flop (didn't bet)
Seat 2: coolercall1 (small blind) collected (7280)
Seat 3: tboymyalias (big blind) folded before Flop
Seat 5: konakiki folded before Flop (didn't bet)
Seat 6: kamane123 folded before Flop (didn't bet)
Seat 9: hzane folded before Flop (didn't bet)



PokerStars Hand #189422864886: Tournament #2367584539, 9000+1000 Hold'em No Limit - Level XXIX (1400/2800) - 2018/08/01 22:47:22 ET
Table '2367584539 35' 9-max Seat #2 is the button
Seat 1: Viceroy1962 (40694 in chips) 
Seat 2: coolercall1 (46782 in chips) 
Seat 3: tboymyalias (13461 in chips) 
Seat 4: Ornery Ed (51000 in chips) 
Seat 5: konakiki (18978 in chips) 
Seat 6: kamane123 (27471 in chips) 
Seat 9: hzane (110290 in chips) 
Viceroy1962: posts the ante 280
coolercall1: posts the ante 280
tboymyalias: posts the ante 280
Ornery Ed: posts the ante 280
konakiki: posts the ante 280
kamane123: posts the ante 280
hzane: posts the ante 280
tboymyalias: posts small blind 1400
Ornery Ed: posts big blind 2800
*** HOLE CARDS ***
Dealt to hzane [4d Qd]
konakiki: folds 
kamane123: folds 
hzane: calls 2800
Viceroy1962: folds 
coolercall1: raises 43702 to 46502 and is all-in
tboymyalias: folds 
Ornery Ed: folds 
hzane: folds 
Uncalled bet (43702) returned to coolercall1
coolercall1 collected 11760 from pot
*** SUMMARY ***
Total pot 11760 | Rake 0 
Seat 1: Viceroy1962 folded before Flop (didn't bet)
Seat 2: coolercall1 (button) collected (11760)
Seat 3: tboymyalias (small blind) folded before Flop
Seat 4: Ornery Ed (big blind) folded before Flop
Seat 5: konakiki folded before Flop (didn't bet)
Seat 6: kamane123 folded before Flop (didn't bet)
Seat 9: hzane folded before Flop



PokerStars Hand #189422870130: Tournament #2367584539, 9000+1000 Hold'em No Limit - Level XXIX (1400/2800) - 2018/08/01 22:47:40 ET
Table '2367584539 35' 9-max Seat #3 is the button
Seat 1: Viceroy1962 (40414 in chips) 
Seat 2: coolercall1 (55462 in chips) 
Seat 3: tboymyalias (11781 in chips) 
Seat 4: Ornery Ed (47920 in chips) 
Seat 5: konakiki (18698 in chips) 
Seat 6: kamane123 (27191 in chips) 
Seat 9: hzane (107210 in chips) 
Viceroy1962: posts the ante 280
coolercall1: posts the ante 280
tboymyalias: posts the ante 280
Ornery Ed: posts the ante 280
konakiki: posts the ante 280
kamane123: posts the ante 280
hzane: posts the ante 280
Ornery Ed: posts small blind 1400
konakiki: posts big blind 2800
*** HOLE CARDS ***
Dealt to hzane [Qc 6h]
kamane123: folds 
hzane: folds 
Viceroy1962: folds 
coolercall1: raises 5600 to 8400
tboymyalias: folds 
Ornery Ed: folds 
konakiki: folds 
Uncalled bet (5600) returned to coolercall1
coolercall1 collected 8960 from pot
*** SUMMARY ***
Total pot 8960 | Rake 0 
Seat 1: Viceroy1962 folded before Flop (didn't bet)
Seat 2: coolercall1 collected (8960)
Seat 3: tboymyalias (button) folded before Flop (didn't bet)
Seat 4: Ornery Ed (small blind) folded before Flop
Seat 5: konakiki (big blind) folded before Flop
Seat 6: kamane123 folded before Flop (didn't bet)
Seat 9: hzane folded before Flop (didn't bet)



PokerStars Hand #189422875321: Tournament #2367584539, 9000+1000 Hold'em No Limit - Level XXIX (1400/2800) - 2018/08/01 22:47:59 ET
Table '2367584539 35' 9-max Seat #4 is the button
Seat 1: Viceroy1962 (40134 in chips) 
Seat 2: coolercall1 (61342 in chips) 
Seat 3: tboymyalias (11501 in chips) 
Seat 4: Ornery Ed (46240 in chips) 
Seat 5: konakiki (15618 in chips) 
Seat 6: kamane123 (26911 in chips) 
Seat 9: hzane (106930 in chips) 
Viceroy1962: posts the ante 280
coolercall1: posts the ante 280
tboymyalias: posts the ante 280
Ornery Ed: posts the ante 280
konakiki: posts the ante 280
kamane123: posts the ante 280
hzane: posts the ante 280
konakiki: posts small blind 1400
kamane123: posts big blind 2800
*** HOLE CARDS ***
Dealt to hzane [Jc Th]
hzane: calls 2800
Viceroy1962: folds 
coolercall1: folds 
tboymyalias: folds 
Ornery Ed: raises 4200 to 7000
konakiki: folds 
kamane123: raises 19631 to 26631 and is all-in
hzane: folds 
Ornery Ed: calls 19631
*** FLOP *** [6h Tc 9h]
*** TURN *** [6h Tc 9h] [Kh]
*** RIVER *** [6h Tc 9h Kh] [4c]
*** SHOW DOWN ***
kamane123: shows [Jh Qs] (a straight, Nine to King)
Ornery Ed: shows [Kd Qh] (a pair of Kings)
kamane123 collected 59422 from pot
*** SUMMARY ***
Total pot 59422 | Rake 0 
Board [6h Tc 9h Kh 4c]
Seat 1: Viceroy1962 folded before Flop (didn't bet)
Seat 2: coolercall1 folded before Flop (didn't bet)
Seat 3: tboymyalias folded before Flop (didn't bet)
Seat 4: Ornery Ed (button) showed [Kd Qh] and lost with a pair of Kings
Seat 5: konakiki (small blind) folded before Flop
Seat 6: kamane123 (big blind) showed [Jh Qs] and won (59422) with a straight, Nine to King
Seat 9: hzane folded before Flop



PokerStars Hand #189422886242: Tournament #2367584539, 9000+1000 Hold'em No Limit - Level XXX (1600/3200) - 2018/08/01 22:48:37 ET
Table '2367584539 35' 9-max Seat #5 is the button
Seat 1: Viceroy1962 (39854 in chips) 
Seat 2: coolercall1 (61062 in chips) 
Seat 3: tboymyalias (11221 in chips) 
Seat 4: Ornery Ed (19329 in chips) 
Seat 5: konakiki (13938 in chips) 
Seat 6: kamane123 (59422 in chips) 
Seat 9: hzane (103850 in chips) 
Viceroy1962: posts the ante 320
coolercall1: posts the ante 320
tboymyalias: posts the ante 320
Ornery Ed: posts the ante 320
konakiki: posts the ante 320
kamane123: posts the ante 320
hzane: posts the ante 320
kamane123: posts small blind 1600
hzane: posts big blind 3200
*** HOLE CARDS ***
Dealt to hzane [Ks Jd]
Viceroy1962: calls 3200
coolercall1: folds 
tboymyalias: calls 3200
Ornery Ed: folds 
konakiki: folds 
kamane123: calls 1600
hzane: raises 3200 to 6400
Viceroy1962: calls 3200
tboymyalias: raises 4501 to 10901 and is all-in
kamane123: calls 7701
hzane: calls 4501
Viceroy1962: calls 4501
*** FLOP *** [2s 3d 7c]
kamane123: bets 3200
hzane: calls 3200
Viceroy1962: calls 3200
*** TURN *** [2s 3d 7c] [Jc]
kamane123: bets 3200
hzane: raises 6400 to 9600
Viceroy1962: folds 
kamane123: calls 6400
*** RIVER *** [2s 3d 7c Jc] [Ts]
kamane123: bets 3200
hzane: raises 9600 to 12800
kamane123: folds 
Uncalled bet (9600) returned to hzane
*** SHOW DOWN ***
hzane: shows [Ks Jd] (a pair of Jacks)
hzane collected 35200 from side pot
tboymyalias: shows [Qh Kd] (high card King)
hzane collected 45844 from main pot
tboymyalias finished the tournament in 19th place and received 37000.
*** SUMMARY ***
Total pot 81044 Main pot 45844. Side pot 35200. | Rake 0 
Board [2s 3d 7c Jc Ts]
Seat 1: Viceroy1962 folded on the Turn
Seat 2: coolercall1 folded before Flop (didn't bet)
Seat 3: tboymyalias showed [Qh Kd] and lost with high card King
Seat 4: Ornery Ed folded before Flop (didn't bet)
Seat 5: konakiki (button) folded before Flop (didn't bet)
Seat 6: kamane123 (small blind) folded on the River
Seat 9: hzane (big blind) showed [Ks Jd] and won (81044) with a pair of Jacks



PokerStars Hand #189422934571: Tournament #2367584539, 9000+1000 Hold'em No Limit - Level XXXI (2000/4000) - 2018/08/01 22:51:29 ET
Table '2367584539 28' 9-max Seat #9 is the button
Seat 1: jimijames211 (21139 in chips) 
Seat 2: fer_dekno (16551 in chips) 
Seat 3: komessi (38555 in chips) 
Seat 4: Aceofspads69 (99370 in chips) 
Seat 5: hzane (157673 in chips) 
Seat 6: kamane123 (32201 in chips) 
Seat 7: konakiki (13618 in chips) 
Seat 9: MmeBreton (49204 in chips) 
jimijames211: posts the ante 400
fer_dekno: posts the ante 400
komessi: posts the ante 400
Aceofspads69: posts the ante 400
hzane: posts the ante 400
kamane123: posts the ante 400
konakiki: posts the ante 400
MmeBreton: posts the ante 400
jimijames211: posts small blind 2000
fer_dekno: posts big blind 4000
*** HOLE CARDS ***
Dealt to hzane [Jh 7s]
komessi: folds 
Aceofspads69: calls 4000
hzane: folds 
kamane123: folds 
konakiki: folds 
MmeBreton: folds 
jimijames211: raises 16739 to 20739 and is all-in
fer_dekno: folds 
Aceofspads69: calls 16739
*** FLOP *** [9d 5c Kd]
*** TURN *** [9d 5c Kd] [3s]
*** RIVER *** [9d 5c Kd 3s] [9s]
*** SHOW DOWN ***
jimijames211: shows [8s As] (a pair of Nines)
Aceofspads69: shows [Ad Tc] (a pair of Nines - Ace+King+Ten kicker)
Aceofspads69 collected 48678 from pot
jimijames211 finished the tournament in 16th place and received 41000.
*** SUMMARY ***
Total pot 48678 | Rake 0 
Board [9d 5c Kd 3s 9s]
Seat 1: jimijames211 (small blind) showed [8s As] and lost with a pair of Nines
Seat 2: fer_dekno (big blind) folded before Flop
Seat 3: komessi folded before Flop (didn't bet)
Seat 4: Aceofspads69 showed [Ad Tc] and won (48678) with a pair of Nines
Seat 5: hzane folded before Flop (didn't bet)
Seat 6: kamane123 folded before Flop (didn't bet)
Seat 7: konakiki folded before Flop (didn't bet)
Seat 9: MmeBreton (button) folded before Flop (didn't bet)



PokerStars Hand #189422946030: Tournament #2367584539, 9000+1000 Hold'em No Limit - Level XXXI (2000/4000) - 2018/08/01 22:52:10 ET
Table '2367584539 28' 9-max Seat #2 is the button
Seat 2: fer_dekno (12151 in chips) 
Seat 3: komessi (38155 in chips) 
Seat 4: Aceofspads69 (126909 in chips) 
Seat 5: hzane (157273 in chips) is sitting out
Seat 6: kamane123 (31801 in chips) 
Seat 7: konakiki (13218 in chips) 
Seat 9: MmeBreton (48804 in chips) 
fer_dekno: posts the ante 400
komessi: posts the ante 400
Aceofspads69: posts the ante 400
hzane: posts the ante 400
kamane123: posts the ante 400
konakiki: posts the ante 400
MmeBreton: posts the ante 400
komessi: posts small blind 2000
Aceofspads69: posts big blind 4000
*** HOLE CARDS ***
Dealt to hzane [Jc Td]
hzane: folds 
kamane123: folds 
konakiki: folds 
MmeBreton: folds 
fer_dekno: folds 
komessi: raises 33755 to 37755 and is all-in
Aceofspads69: folds 
Uncalled bet (33755) returned to komessi
komessi collected 10800 from pot
komessi: doesn't show hand 
*** SUMMARY ***
Total pot 10800 | Rake 0 
Seat 2: fer_dekno (button) folded before Flop (didn't bet)
Seat 3: komessi (small blind) collected (10800)
Seat 4: Aceofspads69 (big blind) folded before Flop
Seat 5: hzane folded before Flop (didn't bet)
Seat 6: kamane123 folded before Flop (didn't bet)
Seat 7: konakiki folded before Flop (didn't bet)
Seat 9: MmeBreton folded before Flop (didn't bet)



PokerStars Hand #189422956332: Tournament #2367584539, 9000+1000 Hold'em No Limit - Level XXXI (2000/4000) - 2018/08/01 22:52:47 ET
Table '2367584539 28' 9-max Seat #3 is the button
Seat 2: fer_dekno (11751 in chips) 
Seat 3: komessi (44555 in chips) 
Seat 4: Aceofspads69 (122509 in chips) 
Seat 5: hzane (156873 in chips) is sitting out
Seat 6: kamane123 (31401 in chips) 
Seat 7: konakiki (12818 in chips) 
Seat 9: MmeBreton (48404 in chips) 
fer_dekno: posts the ante 400
komessi: posts the ante 400
Aceofspads69: posts the ante 400
hzane: posts the ante 400
kamane123: posts the ante 400
konakiki: posts the ante 400
MmeBreton: posts the ante 400
Aceofspads69: posts small blind 2000
hzane: posts big blind 4000
*** HOLE CARDS ***
Dealt to hzane [4c 8h]
kamane123: calls 4000
konakiki: raises 8418 to 12418 and is all-in
MmeBreton: folds 
fer_dekno: folds 
komessi: folds 
Aceofspads69: calls 10418
hzane: folds 
kamane123: calls 8418
*** FLOP *** [3c 9s Jc]
Aceofspads69: checks 
kamane123: bets 4000
Aceofspads69: folds 
Uncalled bet (4000) returned to kamane123
*** TURN *** [3c 9s Jc] [Jd]
*** RIVER *** [3c 9s Jc Jd] [Js]
*** SHOW DOWN ***
kamane123: shows [Kc Qs] (three of a kind, Jacks)
konakiki: shows [Kd Ac] (three of a kind, Jacks - Ace kicker)
konakiki collected 44054 from pot
*** SUMMARY ***
Total pot 44054 | Rake 0 
Board [3c 9s Jc Jd Js]
Seat 2: fer_dekno folded before Flop (didn't bet)
Seat 3: komessi (button) folded before Flop (didn't bet)
Seat 4: Aceofspads69 (small blind) folded on the Flop
Seat 5: hzane (big blind) folded before Flop
Seat 6: kamane123 showed [Kc Qs] and lost with three of a kind, Jacks
Seat 7: konakiki showed [Kd Ac] and won (44054) with three of a kind, Jacks
Seat 9: MmeBreton folded before Flop (didn't bet)



PokerStars Hand #189422971046: Tournament #2367584539, 9000+1000 Hold'em No Limit - Level XXXI (2000/4000) - 2018/08/01 22:53:40 ET
Table '2367584539 28' 9-max Seat #4 is the button
Seat 2: fer_dekno (11351 in chips) 
Seat 3: komessi (44155 in chips) 
Seat 4: Aceofspads69 (109691 in chips) 
Seat 5: hzane (152473 in chips) is sitting out
Seat 6: kamane123 (18583 in chips) 
Seat 7: konakiki (44054 in chips) 
Seat 9: MmeBreton (48004 in chips) 
fer_dekno: posts the ante 400
komessi: posts the ante 400
Aceofspads69: posts the ante 400
hzane: posts the ante 400
kamane123: posts the ante 400
konakiki: posts the ante 400
MmeBreton: posts the ante 400
hzane: posts small blind 2000
kamane123: posts big blind 4000
*** HOLE CARDS ***
Dealt to hzane [3d Ts]
konakiki: folds 
MmeBreton: folds 
fer_dekno: folds 
komessi: folds 
Aceofspads69: folds 
hzane: folds 
Uncalled bet (2000) returned to kamane123
kamane123 collected 6800 from pot
kamane123: doesn't show hand 
*** SUMMARY ***
Total pot 6800 | Rake 0 
Seat 2: fer_dekno folded before Flop (didn't bet)
Seat 3: komessi folded before Flop (didn't bet)
Seat 4: Aceofspads69 (button) folded before Flop (didn't bet)
Seat 5: hzane (small blind) folded before Flop
Seat 6: kamane123 (big blind) collected (6800)
Seat 7: konakiki folded before Flop (didn't bet)
Seat 9: MmeBreton folded before Flop (didn't bet)



PokerStars Hand #189422980432: Tournament #2367584539, 9000+1000 Hold'em No Limit - Level XXXII (2500/5000) - 2018/08/01 22:54:14 ET
Table '2367584539 28' 9-max Seat #5 is the button
Seat 2: fer_dekno (10951 in chips) 
Seat 3: komessi (43755 in chips) 
Seat 4: Aceofspads69 (109291 in chips) 
Seat 5: hzane (150073 in chips) is sitting out
Seat 6: kamane123 (22983 in chips) 
Seat 7: konakiki (43654 in chips) 
Seat 9: MmeBreton (47604 in chips) 
fer_dekno: posts the ante 500
komessi: posts the ante 500
Aceofspads69: posts the ante 500
hzane: posts the ante 500
kamane123: posts the ante 500
konakiki: posts the ante 500
MmeBreton: posts the ante 500
kamane123: posts small blind 2500
konakiki: posts big blind 5000
*** HOLE CARDS ***
Dealt to hzane [4c Ah]
MmeBreton has timed out
MmeBreton: folds 
fer_dekno: folds 
komessi: folds 
Aceofspads69: folds 
hzane: folds 
kamane123: folds 
Uncalled bet (2500) returned to konakiki
konakiki collected 8500 from pot
*** SUMMARY ***
Total pot 8500 | Rake 0 
Seat 2: fer_dekno folded before Flop (didn't bet)
Seat 3: komessi folded before Flop (didn't bet)
Seat 4: Aceofspads69 folded before Flop (didn't bet)
Seat 5: hzane (button) folded before Flop (didn't bet)
Seat 6: kamane123 (small blind) folded before Flop
Seat 7: konakiki (big blind) collected (8500)
Seat 9: MmeBreton folded before Flop (didn't bet)



PokerStars Hand #189422986708: Tournament #2367584539, 9000+1000 Hold'em No Limit - Level XXXII (2500/5000) - 2018/08/01 22:54:36 ET
Table '2367584539 28' 9-max Seat #6 is the button
Seat 2: fer_dekno (10451 in chips) 
Seat 3: komessi (43255 in chips) 
Seat 4: Aceofspads69 (108791 in chips) 
Seat 5: hzane (149573 in chips) is sitting out
Seat 6: kamane123 (19983 in chips) 
Seat 7: konakiki (49154 in chips) 
Seat 9: MmeBreton (47104 in chips) is sitting out
fer_dekno: posts the ante 500
komessi: posts the ante 500
Aceofspads69: posts the ante 500
hzane: posts the ante 500
kamane123: posts the ante 500
konakiki: posts the ante 500
MmeBreton: posts the ante 500
konakiki: posts small blind 2500
MmeBreton: posts big blind 5000
*** HOLE CARDS ***
Dealt to hzane [6h Jc]
fer_dekno: raises 4951 to 9951 and is all-in
komessi: folds 
Aceofspads69 has timed out
Aceofspads69: folds 
hzane: folds 
kamane123: folds 
konakiki: folds 
MmeBreton: calls 4951
*** FLOP *** [Kc 6c 7c]
*** TURN *** [Kc 6c 7c] [8h]
*** RIVER *** [Kc 6c 7c 8h] [Tc]
*** SHOW DOWN ***
MmeBreton: shows [Qh Ts] (a pair of Tens)
fer_dekno: shows [As Ah] (a pair of Aces)
fer_dekno collected 25902 from pot
*** SUMMARY ***
Total pot 25902 | Rake 0 
Board [Kc 6c 7c 8h Tc]
Seat 2: fer_dekno showed [As Ah] and won (25902) with a pair of Aces
Seat 3: komessi folded before Flop (didn't bet)
Seat 4: Aceofspads69 folded before Flop (didn't bet)
Seat 5: hzane folded before Flop (didn't bet)
Seat 6: kamane123 (button) folded before Flop (didn't bet)
Seat 7: konakiki (small blind) folded before Flop
Seat 9: MmeBreton (big blind) showed [Qh Ts] and lost with a pair of Tens



PokerStars Hand #189423081145: Tournament #2367584539, 9000+1000 Hold'em No Limit - Level XXXII (2500/5000) - 2018/08/01 23:00:18 ET
Table '2367584539 28' 9-max Seat #7 is the button
Seat 2: fer_dekno (25902 in chips) 
Seat 3: komessi (42755 in chips) 
Seat 4: Aceofspads69 (108291 in chips) 
Seat 5: hzane (149073 in chips) is sitting out
Seat 6: kamane123 (19483 in chips) 
Seat 7: konakiki (46154 in chips) 
Seat 9: MmeBreton (36653 in chips) 
fer_dekno: posts the ante 500
komessi: posts the ante 500
Aceofspads69: posts the ante 500
hzane: posts the ante 500
kamane123: posts the ante 500
konakiki: posts the ante 500
MmeBreton: posts the ante 500
MmeBreton: posts small blind 2500
fer_dekno: posts big blind 5000
*** HOLE CARDS ***
Dealt to hzane [Tc 2h]
komessi: raises 37255 to 42255 and is all-in
Aceofspads69: folds 
hzane: folds 
kamane123: folds 
konakiki: folds 
MmeBreton: calls 33653 and is all-in
fer_dekno: folds 
Uncalled bet (6102) returned to komessi
*** FLOP *** [Kc As 7d]
*** TURN *** [Kc As 7d] [4s]
*** RIVER *** [Kc As 7d 4s] [9s]
*** SHOW DOWN ***
MmeBreton: shows [Qs Qd] (a pair of Queens)
komessi: shows [Ah Qc] (a pair of Aces)
komessi collected 80806 from pot
MmeBreton finished the tournament in 14th place and received 45000.
*** SUMMARY ***
Total pot 80806 | Rake 0 
Board [Kc As 7d 4s 9s]
Seat 2: fer_dekno (big blind) folded before Flop
Seat 3: komessi showed [Ah Qc] and won (80806) with a pair of Aces
Seat 4: Aceofspads69 folded before Flop (didn't bet)
Seat 5: hzane folded before Flop (didn't bet)
Seat 6: kamane123 folded before Flop (didn't bet)
Seat 7: konakiki (button) folded before Flop (didn't bet)
Seat 9: MmeBreton (small blind) showed [Qs Qd] and lost with a pair of Queens



PokerStars Hand #189423087446: Tournament #2367584539, 9000+1000 Hold'em No Limit - Level XXXII (2500/5000) - 2018/08/01 23:00:43 ET
Table '2367584539 28' 9-max Seat #2 is the button
Seat 2: fer_dekno (20402 in chips) 
Seat 3: komessi (86908 in chips) 
Seat 4: Aceofspads69 (107791 in chips) 
Seat 5: hzane (148573 in chips) is sitting out
Seat 6: kamane123 (18983 in chips) 
Seat 7: konakiki (45654 in chips) 
fer_dekno: posts the ante 500
komessi: posts the ante 500
Aceofspads69: posts the ante 500
hzane: posts the ante 500
kamane123: posts the ante 500
konakiki: posts the ante 500
komessi: posts small blind 2500
Aceofspads69: posts big blind 5000
*** HOLE CARDS ***
Dealt to hzane [2c 5d]
hzane: folds 
kamane123: calls 5000
konakiki: folds 
fer_dekno: folds 
komessi: calls 2500
Aceofspads69: checks 
*** FLOP *** [8c 7s As]
komessi: bets 5580
Aceofspads69: folds 
kamane123: calls 5580
*** TURN *** [8c 7s As] [4c]
komessi: bets 14288
kamane123: calls 7903 and is all-in
Uncalled bet (6385) returned to komessi
*** RIVER *** [8c 7s As 4c] [7d]
*** SHOW DOWN ***
komessi: shows [Kc 8d] (two pair, Eights and Sevens)
kamane123: shows [Ks Ts] (a pair of Sevens)
komessi collected 44966 from pot
kamane123 finished the tournament in 11th place and received 50000.
*** SUMMARY ***
Total pot 44966 | Rake 0 
Board [8c 7s As 4c 7d]
Seat 2: fer_dekno (button) folded before Flop (didn't bet)
Seat 3: komessi (small blind) showed [Kc 8d] and won (44966) with two pair, Eights and Sevens
Seat 4: Aceofspads69 (big blind) folded on the Flop
Seat 5: hzane folded before Flop (didn't bet)
Seat 6: kamane123 showed [Ks Ts] and lost with a pair of Sevens
Seat 7: konakiki folded before Flop (didn't bet)



PokerStars Hand #189423098642: Tournament #2367584539, 9000+1000 Hold'em No Limit - Level XXXII (2500/5000) - 2018/08/01 23:01:25 ET
Table '2367584539 28' 9-max Seat #3 is the button
Seat 2: fer_dekno (19902 in chips) 
Seat 3: komessi (112891 in chips) 
Seat 4: Aceofspads69 (102291 in chips) 
Seat 5: hzane (148073 in chips) is sitting out
Seat 7: konakiki (45154 in chips) 
fer_dekno: posts the ante 500
komessi: posts the ante 500
Aceofspads69: posts the ante 500
hzane: posts the ante 500
konakiki: posts the ante 500
Aceofspads69: posts small blind 2500
hzane: posts big blind 5000
*** HOLE CARDS ***
Dealt to hzane [2h Td]
konakiki: folds 
fer_dekno: raises 14402 to 19402 and is all-in
komessi: folds 
Aceofspads69: calls 16902
hzane: folds 
*** FLOP *** [Kc Ah 9c]
*** TURN *** [Kc Ah 9c] [7d]
*** RIVER *** [Kc Ah 9c 7d] [Jd]
*** SHOW DOWN ***
Aceofspads69: shows [8d As] (a pair of Aces)
fer_dekno: shows [8c 8s] (a pair of Eights)
Aceofspads69 collected 46304 from pot
fer_dekno finished the tournament in 10th place and received 50000.
*** SUMMARY ***
Total pot 46304 | Rake 0 
Board [Kc Ah 9c 7d Jd]
Seat 2: fer_dekno showed [8c 8s] and lost with a pair of Eights
Seat 3: komessi (button) folded before Flop (didn't bet)
Seat 4: Aceofspads69 (small blind) showed [8d As] and won (46304) with a pair of Aces
Seat 5: hzane (big blind) folded before Flop
Seat 7: konakiki folded before Flop (didn't bet)



PokerStars Hand #189423106640: Tournament #2367584539, 9000+1000 Hold'em No Limit - Level XXXII (2500/5000) - 2018/08/01 23:01:55 ET
Table '2367584539 23' 9-max Seat #5 is the button
Seat 1: legalsmile (5246 in chips) 
Seat 2: Aceofspads69 (128693 in chips) 
Seat 3: coolercall1 (92370 in chips) 
Seat 4: hzane (142573 in chips) is sitting out
Seat 5: Jchacall (11524 in chips) 
Seat 6: filmguysc (116036 in chips) 
Seat 7: komessi (112391 in chips) 
Seat 8: konakiki (44654 in chips) 
Seat 9: Viceroy1962 (30513 in chips) 
legalsmile: posts the ante 500
Aceofspads69: posts the ante 500
coolercall1: posts the ante 500
hzane: posts the ante 500
Jchacall: posts the ante 500
filmguysc: posts the ante 500
komessi: posts the ante 500
konakiki: posts the ante 500
Viceroy1962: posts the ante 500
filmguysc: posts small blind 2500
komessi: posts big blind 5000
*** HOLE CARDS ***
Dealt to hzane [3d Qd]
konakiki: folds 
Viceroy1962: raises 25013 to 30013 and is all-in
legalsmile: folds 
Aceofspads69: calls 30013
coolercall1: folds 
hzane: folds 
Jchacall: folds 
filmguysc: folds 
komessi: folds 
*** FLOP *** [6s 2h 6h]
*** TURN *** [6s 2h 6h] [Ac]
*** RIVER *** [6s 2h 6h Ac] [8d]
*** SHOW DOWN ***
Viceroy1962: shows [Ad 8c] (two pair, Aces and Eights)
Aceofspads69: shows [Ks Td] (a pair of Sixes)
Viceroy1962 collected 72026 from pot
*** SUMMARY ***
Total pot 72026 | Rake 0 
Board [6s 2h 6h Ac 8d]
Seat 1: legalsmile folded before Flop (didn't bet)
Seat 2: Aceofspads69 showed [Ks Td] and lost with a pair of Sixes
Seat 3: coolercall1 folded before Flop (didn't bet)
Seat 4: hzane folded before Flop (didn't bet)
Seat 5: Jchacall (button) folded before Flop (didn't bet)
Seat 6: filmguysc (small blind) folded before Flop
Seat 7: komessi (big blind) folded before Flop
Seat 8: konakiki folded before Flop (didn't bet)
Seat 9: Viceroy1962 showed [Ad 8c] and won (72026) with two pair, Aces and Eights



PokerStars Hand #189423116911: Tournament #2367584539, 9000+1000 Hold'em No Limit - Level XXXIII (3000/6000) - 2018/08/01 23:02:32 ET
Table '2367584539 23' 9-max Seat #6 is the button
Seat 1: legalsmile (4746 in chips) 
Seat 2: Aceofspads69 (98180 in chips) 
Seat 3: coolercall1 (91870 in chips) 
Seat 4: hzane (142073 in chips) is sitting out
Seat 5: Jchacall (11024 in chips) 
Seat 6: filmguysc (113036 in chips) 
Seat 7: komessi (106891 in chips) 
Seat 8: konakiki (44154 in chips) 
Seat 9: Viceroy1962 (72026 in chips) 
legalsmile: posts the ante 600
Aceofspads69: posts the ante 600
coolercall1: posts the ante 600
hzane: posts the ante 600
Jchacall: posts the ante 600
filmguysc: posts the ante 600
komessi: posts the ante 600
konakiki: posts the ante 600
Viceroy1962: posts the ante 600
komessi: posts small blind 3000
konakiki: posts big blind 6000
*** HOLE CARDS ***
Dealt to hzane [3c 4h]
Viceroy1962: folds 
legalsmile: folds 
Aceofspads69: calls 6000
coolercall1: folds 
hzane: folds 
Jchacall: folds 
filmguysc: folds 
komessi: calls 3000
konakiki: checks 
*** FLOP *** [7h 2d Jh]
komessi: bets 7254
konakiki: folds 
Aceofspads69: folds 
Uncalled bet (7254) returned to komessi
komessi collected 23400 from pot
komessi: doesn't show hand 
*** SUMMARY ***
Total pot 23400 | Rake 0 
Board [7h 2d Jh]
Seat 1: legalsmile folded before Flop (didn't bet)
Seat 2: Aceofspads69 folded on the Flop
Seat 3: coolercall1 folded before Flop (didn't bet)
Seat 4: hzane folded before Flop (didn't bet)
Seat 5: Jchacall folded before Flop (didn't bet)
Seat 6: filmguysc (button) folded before Flop (didn't bet)
Seat 7: komessi (small blind) collected (23400)
Seat 8: konakiki (big blind) folded on the Flop
Seat 9: Viceroy1962 folded before Flop (didn't bet)



PokerStars Hand #189423127034: Tournament #2367584539, 9000+1000 Hold'em No Limit - Level XXXIII (3000/6000) - 2018/08/01 23:03:10 ET
Table '2367584539 23' 9-max Seat #7 is the button
Seat 1: legalsmile (4146 in chips) 
Seat 2: Aceofspads69 (91580 in chips) 
Seat 3: coolercall1 (91270 in chips) 
Seat 4: hzane (141473 in chips) 
Seat 5: Jchacall (10424 in chips) 
Seat 6: filmguysc (112436 in chips) 
Seat 7: komessi (123691 in chips) 
Seat 8: konakiki (37554 in chips) 
Seat 9: Viceroy1962 (71426 in chips) 
legalsmile: posts the ante 600
Aceofspads69: posts the ante 600
coolercall1: posts the ante 600
hzane: posts the ante 600
Jchacall: posts the ante 600
filmguysc: posts the ante 600
komessi: posts the ante 600
konakiki: posts the ante 600
Viceroy1962: posts the ante 600
konakiki: posts small blind 3000
Viceroy1962: posts big blind 6000
*** HOLE CARDS ***
Dealt to hzane [8d 5d]
legalsmile: folds 
Aceofspads69: raises 20400 to 26400
coolercall1: folds 
hzane: folds 
Jchacall: folds 
filmguysc: folds 
komessi: folds 
konakiki: folds 
Viceroy1962: folds 
Uncalled bet (20400) returned to Aceofspads69
Aceofspads69 collected 20400 from pot
Aceofspads69: doesn't show hand 
*** SUMMARY ***
Total pot 20400 | Rake 0 
Seat 1: legalsmile folded before Flop (didn't bet)
Seat 2: Aceofspads69 collected (20400)
Seat 3: coolercall1 folded before Flop (didn't bet)
Seat 4: hzane folded before Flop (didn't bet)
Seat 5: Jchacall folded before Flop (didn't bet)
Seat 6: filmguysc folded before Flop (didn't bet)
Seat 7: komessi (button) folded before Flop (didn't bet)
Seat 8: konakiki (small blind) folded before Flop
Seat 9: Viceroy1962 (big blind) folded before Flop



PokerStars Hand #189423131470: Tournament #2367584539, 9000+1000 Hold'em No Limit - Level XXXIII (3000/6000) - 2018/08/01 23:03:26 ET
Table '2367584539 23' 9-max Seat #8 is the button
Seat 1: legalsmile (3546 in chips) 
Seat 2: Aceofspads69 (105380 in chips) 
Seat 3: coolercall1 (90670 in chips) 
Seat 4: hzane (140873 in chips) 
Seat 5: Jchacall (9824 in chips) 
Seat 6: filmguysc (111836 in chips) 
Seat 7: komessi (123091 in chips) 
Seat 8: konakiki (33954 in chips) 
Seat 9: Viceroy1962 (64826 in chips) 
legalsmile: posts the ante 600
Aceofspads69: posts the ante 600
coolercall1: posts the ante 600
hzane: posts the ante 600
Jchacall: posts the ante 600
filmguysc: posts the ante 600
komessi: posts the ante 600
konakiki: posts the ante 600
Viceroy1962: posts the ante 600
Viceroy1962: posts small blind 3000
legalsmile: posts big blind 2946 and is all-in
*** HOLE CARDS ***
Dealt to hzane [9c Tc]
Aceofspads69: folds 
coolercall1: raises 9000 to 12000
hzane: calls 12000
Jchacall: folds 
filmguysc: folds 
komessi: folds 
konakiki: folds 
Viceroy1962: folds 
*** FLOP *** [7d 7s Js]
coolercall1: bets 78070 and is all-in
hzane: folds 
Uncalled bet (78070) returned to coolercall1
*** TURN *** [7d 7s Js] [Jd]
*** RIVER *** [7d 7s Js Jd] [6s]
*** SHOW DOWN ***
coolercall1: shows [Jc Ts] (a full house, Jacks full of Sevens)
coolercall1 collected 18162 from side pot
legalsmile: shows [7h 3s] (a full house, Sevens full of Jacks)
coolercall1 collected 17184 from main pot
legalsmile finished the tournament in 9th place and received 56000.
*** SUMMARY ***
Total pot 35346 Main pot 17184. Side pot 18162. | Rake 0 
Board [7d 7s Js Jd 6s]
Seat 1: legalsmile (big blind) showed [7h 3s] and lost with a full house, Sevens full of Jacks
Seat 2: Aceofspads69 folded before Flop (didn't bet)
Seat 3: coolercall1 showed [Jc Ts] and won (35346) with a full house, Jacks full of Sevens
Seat 4: hzane folded on the Flop
Seat 5: Jchacall folded before Flop (didn't bet)
Seat 6: filmguysc folded before Flop (didn't bet)
Seat 7: komessi folded before Flop (didn't bet)
Seat 8: konakiki (button) folded before Flop (didn't bet)
Seat 9: Viceroy1962 (small blind) folded before Flop



PokerStars Hand #189423141888: Tournament #2367584539, 9000+1000 Hold'em No Limit - Level XXXIII (3000/6000) - 2018/08/01 23:04:05 ET
Table '2367584539 23' 9-max Seat #9 is the button
Seat 2: Aceofspads69 (104780 in chips) 
Seat 3: coolercall1 (113416 in chips) 
Seat 4: hzane (128273 in chips) 
Seat 5: Jchacall (9224 in chips) 
Seat 6: filmguysc (111236 in chips) 
Seat 7: komessi (122491 in chips) 
Seat 8: konakiki (33354 in chips) 
Seat 9: Viceroy1962 (61226 in chips) 
Aceofspads69: posts the ante 600
coolercall1: posts the ante 600
hzane: posts the ante 600
Jchacall: posts the ante 600
filmguysc: posts the ante 600
komessi: posts the ante 600
konakiki: posts the ante 600
Viceroy1962: posts the ante 600
Aceofspads69: posts small blind 3000
coolercall1: posts big blind 6000
*** HOLE CARDS ***
Dealt to hzane [6s 4c]
hzane: folds 
Jchacall: folds 
filmguysc: raises 8000 to 14000
komessi: folds 
konakiki: folds 
Viceroy1962: folds 
Aceofspads69: folds 
coolercall1: folds 
Uncalled bet (8000) returned to filmguysc
filmguysc collected 19800 from pot
filmguysc: doesn't show hand 
*** SUMMARY ***
Total pot 19800 | Rake 0 
Seat 2: Aceofspads69 (small blind) folded before Flop
Seat 3: coolercall1 (big blind) folded before Flop
Seat 4: hzane folded before Flop (didn't bet)
Seat 5: Jchacall folded before Flop (didn't bet)
Seat 6: filmguysc collected (19800)
Seat 7: komessi folded before Flop (didn't bet)
Seat 8: konakiki folded before Flop (didn't bet)
Seat 9: Viceroy1962 (button) folded before Flop (didn't bet)



PokerStars Hand #189423148543: Tournament #2367584539, 9000+1000 Hold'em No Limit - Level XXXIII (3000/6000) - 2018/08/01 23:04:29 ET
Table '2367584539 23' 9-max Seat #2 is the button
Seat 2: Aceofspads69 (101180 in chips) 
Seat 3: coolercall1 (106816 in chips) 
Seat 4: hzane (127673 in chips) 
Seat 5: Jchacall (8624 in chips) 
Seat 6: filmguysc (124436 in chips) 
Seat 7: komessi (121891 in chips) 
Seat 8: konakiki (32754 in chips) 
Seat 9: Viceroy1962 (60626 in chips) 
Aceofspads69: posts the ante 600
coolercall1: posts the ante 600
hzane: posts the ante 600
Jchacall: posts the ante 600
filmguysc: posts the ante 600
komessi: posts the ante 600
konakiki: posts the ante 600
Viceroy1962: posts the ante 600
coolercall1: posts small blind 3000
hzane: posts big blind 6000
*** HOLE CARDS ***
Dealt to hzane [6s Qd]
Jchacall: folds 
filmguysc: folds 
komessi: raises 7200 to 13200
konakiki: folds 
Viceroy1962: folds 
Aceofspads69: raises 87380 to 100580 and is all-in
coolercall1: folds 
hzane: folds 
komessi: folds 
Uncalled bet (87380) returned to Aceofspads69
Aceofspads69 collected 40200 from pot
Aceofspads69: doesn't show hand 
*** SUMMARY ***
Total pot 40200 | Rake 0 
Seat 2: Aceofspads69 (button) collected (40200)
Seat 3: coolercall1 (small blind) folded before Flop
Seat 4: hzane (big blind) folded before Flop
Seat 5: Jchacall folded before Flop (didn't bet)
Seat 6: filmguysc folded before Flop (didn't bet)
Seat 7: komessi folded before Flop
Seat 8: konakiki folded before Flop (didn't bet)
Seat 9: Viceroy1962 folded before Flop (didn't bet)



PokerStars Hand #189423156874: Tournament #2367584539, 9000+1000 Hold'em No Limit - Level XXXIII (3000/6000) - 2018/08/01 23:05:00 ET
Table '2367584539 23' 9-max Seat #3 is the button
Seat 2: Aceofspads69 (127580 in chips) 
Seat 3: coolercall1 (103216 in chips) 
Seat 4: hzane (121073 in chips) 
Seat 5: Jchacall (8024 in chips) 
Seat 6: filmguysc (123836 in chips) 
Seat 7: komessi (108091 in chips) 
Seat 8: konakiki (32154 in chips) 
Seat 9: Viceroy1962 (60026 in chips) 
Aceofspads69: posts the ante 600
coolercall1: posts the ante 600
hzane: posts the ante 600
Jchacall: posts the ante 600
filmguysc: posts the ante 600
komessi: posts the ante 600
konakiki: posts the ante 600
Viceroy1962: posts the ante 600
hzane: posts small blind 3000
Jchacall: posts big blind 6000
*** HOLE CARDS ***
Dealt to hzane [Ah 5h]
filmguysc: folds 
komessi: folds 
konakiki: folds 
Viceroy1962: calls 6000
Aceofspads69: calls 6000
coolercall1: folds 
hzane: calls 3000
Jchacall: checks 
*** FLOP *** [Th As Ac]
hzane: checks 
Jchacall: bets 1424 and is all-in
Viceroy1962: calls 1424
Aceofspads69: calls 1424
hzane: raises 4576 to 6000
Viceroy1962: raises 47426 to 53426 and is all-in
Aceofspads69: folds 
hzane: calls 47426
*** TURN *** [Th As Ac] [3h]
*** RIVER *** [Th As Ac 3h] [3c]
*** SHOW DOWN ***
hzane: shows [Ah 5h] (a full house, Aces full of Threes)
Viceroy1962: shows [4c Ad] (a full house, Aces full of Threes)
hzane collected 52002 from side pot
Viceroy1962 collected 52002 from side pot
Jchacall: shows [Ts Jh] (two pair, Aces and Tens)
hzane collected 17248 from main pot
Viceroy1962 collected 17248 from main pot
Jchacall finished the tournament in 8th place and received 64000.
*** SUMMARY ***
Total pot 138500 Main pot 34496. Side pot 104004. | Rake 0 
Board [Th As Ac 3h 3c]
Seat 2: Aceofspads69 folded on the Flop
Seat 3: coolercall1 (button) folded before Flop (didn't bet)
Seat 4: hzane (small blind) showed [Ah 5h] and won (69250) with a full house, Aces full of Threes
Seat 5: Jchacall (big blind) showed [Ts Jh] and lost with two pair, Aces and Tens
Seat 6: filmguysc folded before Flop (didn't bet)
Seat 7: komessi folded before Flop (didn't bet)
Seat 8: konakiki folded before Flop (didn't bet)
Seat 9: Viceroy1962 showed [4c Ad] and won (69250) with a full house, Aces full of Threes



PokerStars Hand #189423169934: Tournament #2367584539, 9000+1000 Hold'em No Limit - Level XXXIV (3500/7000) - 2018/08/01 23:05:48 ET
Table '2367584539 23' 9-max Seat #4 is the button
Seat 2: Aceofspads69 (119556 in chips) 
Seat 3: coolercall1 (102616 in chips) 
Seat 4: hzane (130297 in chips) 
Seat 6: filmguysc (123236 in chips) 
Seat 7: komessi (107491 in chips) 
Seat 8: konakiki (31554 in chips) 
Seat 9: Viceroy1962 (69250 in chips) 
Aceofspads69: posts the ante 700
coolercall1: posts the ante 700
hzane: posts the ante 700
filmguysc: posts the ante 700
komessi: posts the ante 700
konakiki: posts the ante 700
Viceroy1962: posts the ante 700
filmguysc: posts small blind 3500
komessi: posts big blind 7000
*** HOLE CARDS ***
Dealt to hzane [Kd 3h]
konakiki: folds 
Viceroy1962: folds 
Aceofspads69: calls 7000
coolercall1: folds 
hzane: folds 
filmguysc: calls 3500
komessi: checks 
*** FLOP *** [Qh 2s 9c]
filmguysc: checks 
komessi: bets 8029
Aceofspads69: raises 103827 to 111856 and is all-in
filmguysc: folds 
komessi: calls 91762 and is all-in
Uncalled bet (12065) returned to Aceofspads69
*** TURN *** [Qh 2s 9c] [Th]
*** RIVER *** [Qh 2s 9c Th] [8d]
*** SHOW DOWN ***
komessi: shows [Qs 6h] (a pair of Queens)
Aceofspads69: shows [As 2c] (a pair of Deuces)
komessi collected 225482 from pot
*** SUMMARY ***
Total pot 225482 | Rake 0 
Board [Qh 2s 9c Th 8d]
Seat 2: Aceofspads69 showed [As 2c] and lost with a pair of Deuces
Seat 3: coolercall1 folded before Flop (didn't bet)
Seat 4: hzane (button) folded before Flop (didn't bet)
Seat 6: filmguysc (small blind) folded on the Flop
Seat 7: komessi (big blind) showed [Qs 6h] and won (225482) with a pair of Queens
Seat 8: konakiki folded before Flop (didn't bet)
Seat 9: Viceroy1962 folded before Flop (didn't bet)



PokerStars Hand #189423183052: Tournament #2367584539, 9000+1000 Hold'em No Limit - Level XXXIV (3500/7000) - 2018/08/01 23:06:36 ET
Table '2367584539 23' 9-max Seat #6 is the button
Seat 2: Aceofspads69 (12065 in chips) 
Seat 3: coolercall1 (101916 in chips) 
Seat 4: hzane (129597 in chips) 
Seat 6: filmguysc (115536 in chips) 
Seat 7: komessi (225482 in chips) 
Seat 8: konakiki (30854 in chips) 
Seat 9: Viceroy1962 (68550 in chips) 
Aceofspads69: posts the ante 700
coolercall1: posts the ante 700
hzane: posts the ante 700
filmguysc: posts the ante 700
komessi: posts the ante 700
konakiki: posts the ante 700
Viceroy1962: posts the ante 700
komessi: posts small blind 3500
konakiki: posts big blind 7000
*** HOLE CARDS ***
Dealt to hzane [2c 5d]
Viceroy1962: folds 
Aceofspads69: calls 7000
coolercall1: folds 
hzane: folds 
filmguysc: raises 8836 to 15836
komessi: folds 
konakiki: folds 
Aceofspads69: calls 4365 and is all-in
Uncalled bet (4471) returned to filmguysc
*** FLOP *** [9d 2h Kh]
*** TURN *** [9d 2h Kh] [7c]
*** RIVER *** [9d 2h Kh 7c] [Jc]
*** SHOW DOWN ***
Aceofspads69: shows [Qs 5s] (high card King)
filmguysc: shows [7h As] (a pair of Sevens)
filmguysc collected 38130 from pot
Aceofspads69 finished the tournament in 7th place and received 73000.
*** SUMMARY ***
Total pot 38130 | Rake 0 
Board [9d 2h Kh 7c Jc]
Seat 2: Aceofspads69 showed [Qs 5s] and lost with high card King
Seat 3: coolercall1 folded before Flop (didn't bet)
Seat 4: hzane folded before Flop (didn't bet)
Seat 6: filmguysc (button) showed [7h As] and won (38130) with a pair of Sevens
Seat 7: komessi (small blind) folded before Flop
Seat 8: konakiki (big blind) folded before Flop
Seat 9: Viceroy1962 folded before Flop (didn't bet)



PokerStars Hand #189423191692: Tournament #2367584539, 9000+1000 Hold'em No Limit - Level XXXIV (3500/7000) - 2018/08/01 23:07:07 ET
Table '2367584539 23' 9-max Seat #7 is the button
Seat 3: coolercall1 (101216 in chips) 
Seat 4: hzane (128897 in chips) 
Seat 6: filmguysc (141601 in chips) 
Seat 7: komessi (221282 in chips) 
Seat 8: konakiki (23154 in chips) 
Seat 9: Viceroy1962 (67850 in chips) 
coolercall1: posts the ante 700
hzane: posts the ante 700
filmguysc: posts the ante 700
komessi: posts the ante 700
konakiki: posts the ante 700
Viceroy1962: posts the ante 700
konakiki: posts small blind 3500
Viceroy1962: posts big blind 7000
*** HOLE CARDS ***
Dealt to hzane [Td 7s]
coolercall1: raises 93516 to 100516 and is all-in
hzane: folds 
filmguysc: folds 
komessi: folds 
konakiki: folds 
Viceroy1962: folds 
Uncalled bet (93516) returned to coolercall1
coolercall1 collected 21700 from pot
*** SUMMARY ***
Total pot 21700 | Rake 0 
Seat 3: coolercall1 collected (21700)
Seat 4: hzane folded before Flop (didn't bet)
Seat 6: filmguysc folded before Flop (didn't bet)
Seat 7: komessi (button) folded before Flop (didn't bet)
Seat 8: konakiki (small blind) folded before Flop
Seat 9: Viceroy1962 (big blind) folded before Flop



PokerStars Hand #189423195697: Tournament #2367584539, 9000+1000 Hold'em No Limit - Level XXXIV (3500/7000) - 2018/08/01 23:07:22 ET
Table '2367584539 23' 9-max Seat #8 is the button
Seat 3: coolercall1 (115216 in chips) 
Seat 4: hzane (128197 in chips) 
Seat 6: filmguysc (140901 in chips) 
Seat 7: komessi (220582 in chips) 
Seat 8: konakiki (18954 in chips) 
Seat 9: Viceroy1962 (60150 in chips) 
coolercall1: posts the ante 700
hzane: posts the ante 700
filmguysc: posts the ante 700
komessi: posts the ante 700
konakiki: posts the ante 700
Viceroy1962: posts the ante 700
Viceroy1962: posts small blind 3500
coolercall1: posts big blind 7000
*** HOLE CARDS ***
Dealt to hzane [Jc 2h]
hzane: folds 
filmguysc: raises 14000 to 21000
komessi: folds 
konakiki: folds 
Viceroy1962: folds 
coolercall1: folds 
Uncalled bet (14000) returned to filmguysc
filmguysc collected 21700 from pot
filmguysc: doesn't show hand 
*** SUMMARY ***
Total pot 21700 | Rake 0 
Seat 3: coolercall1 (big blind) folded before Flop
Seat 4: hzane folded before Flop (didn't bet)
Seat 6: filmguysc collected (21700)
Seat 7: komessi folded before Flop (didn't bet)
Seat 8: konakiki (button) folded before Flop (didn't bet)
Seat 9: Viceroy1962 (small blind) folded before Flop



PokerStars Hand #189423198675: Tournament #2367584539, 9000+1000 Hold'em No Limit - Level XXXIV (3500/7000) - 2018/08/01 23:07:34 ET
Table '2367584539 23' 9-max Seat #9 is the button
Seat 3: coolercall1 (107516 in chips) 
Seat 4: hzane (127497 in chips) 
Seat 6: filmguysc (154901 in chips) 
Seat 7: komessi (219882 in chips) 
Seat 8: konakiki (18254 in chips) 
Seat 9: Viceroy1962 (55950 in chips) 
coolercall1: posts the ante 700
hzane: posts the ante 700
filmguysc: posts the ante 700
komessi: posts the ante 700
konakiki: posts the ante 700
Viceroy1962: posts the ante 700
coolercall1: posts small blind 3500
hzane: posts big blind 7000
*** HOLE CARDS ***
Dealt to hzane [3h 7d]
filmguysc: folds 
komessi: raises 8400 to 15400
konakiki: calls 15400
Viceroy1962: folds 
coolercall1: folds 
hzane: folds 
*** FLOP *** [6s 7s 3d]
komessi: bets 7000
konakiki: calls 2154 and is all-in
Uncalled bet (4846) returned to komessi
*** TURN *** [6s 7s 3d] [4s]
*** RIVER *** [6s 7s 3d 4s] [6c]
*** SHOW DOWN ***
komessi: shows [9c Jc] (a pair of Sixes)
konakiki: shows [Kd Kc] (two pair, Kings and Sixes)
konakiki collected 49808 from pot
*** SUMMARY ***
Total pot 49808 | Rake 0 
Board [6s 7s 3d 4s 6c]
Seat 3: coolercall1 (small blind) folded before Flop
Seat 4: hzane (big blind) folded before Flop
Seat 6: filmguysc folded before Flop (didn't bet)
Seat 7: komessi showed [9c Jc] and lost with a pair of Sixes
Seat 8: konakiki showed [Kd Kc] and won (49808) with two pair, Kings and Sixes
Seat 9: Viceroy1962 (button) folded before Flop (didn't bet)



PokerStars Hand #189423207083: Tournament #2367584539, 9000+1000 Hold'em No Limit - Level XXXIV (3500/7000) - 2018/08/01 23:08:05 ET
Table '2367584539 23' 9-max Seat #3 is the button
Seat 3: coolercall1 (103316 in chips) 
Seat 4: hzane (119797 in chips) 
Seat 6: filmguysc (154201 in chips) 
Seat 7: komessi (201628 in chips) 
Seat 8: konakiki (49808 in chips) 
Seat 9: Viceroy1962 (55250 in chips) 
coolercall1: posts the ante 700
hzane: posts the ante 700
filmguysc: posts the ante 700
komessi: posts the ante 700
konakiki: posts the ante 700
Viceroy1962: posts the ante 700
hzane: posts small blind 3500
filmguysc: posts big blind 7000
*** HOLE CARDS ***
Dealt to hzane [Qh 3c]
komessi: folds 
konakiki: folds 
Viceroy1962: folds 
coolercall1: raises 14000 to 21000
hzane: folds 
filmguysc: folds 
Uncalled bet (14000) returned to coolercall1
coolercall1 collected 21700 from pot
coolercall1: doesn't show hand 
*** SUMMARY ***
Total pot 21700 | Rake 0 
Seat 3: coolercall1 (button) collected (21700)
Seat 4: hzane (small blind) folded before Flop
Seat 6: filmguysc (big blind) folded before Flop
Seat 7: komessi folded before Flop (didn't bet)
Seat 8: konakiki folded before Flop (didn't bet)
Seat 9: Viceroy1962 folded before Flop (didn't bet)



PokerStars Hand #189423210308: Tournament #2367584539, 9000+1000 Hold'em No Limit - Level XXXIV (3500/7000) - 2018/08/01 23:08:17 ET
Table '2367584539 23' 9-max Seat #4 is the button
Seat 3: coolercall1 (117316 in chips) 
Seat 4: hzane (115597 in chips) 
Seat 6: filmguysc (146501 in chips) 
Seat 7: komessi (200928 in chips) 
Seat 8: konakiki (49108 in chips) 
Seat 9: Viceroy1962 (54550 in chips) 
coolercall1: posts the ante 700
hzane: posts the ante 700
filmguysc: posts the ante 700
komessi: posts the ante 700
konakiki: posts the ante 700
Viceroy1962: posts the ante 700
filmguysc: posts small blind 3500
komessi: posts big blind 7000
*** HOLE CARDS ***
Dealt to hzane [Js Jd]
konakiki: folds 
Viceroy1962: folds 
coolercall1: folds 
hzane: raises 7000 to 14000
filmguysc: folds 
komessi: calls 7000
*** FLOP *** [6c Ks Kd]
komessi: checks 
hzane: bets 14000
komessi: folds 
Uncalled bet (14000) returned to hzane
hzane collected 35700 from pot
*** SUMMARY ***
Total pot 35700 | Rake 0 
Board [6c Ks Kd]
Seat 3: coolercall1 folded before Flop (didn't bet)
Seat 4: hzane (button) collected (35700)
Seat 6: filmguysc (small blind) folded before Flop
Seat 7: komessi (big blind) folded on the Flop
Seat 8: konakiki folded before Flop (didn't bet)
Seat 9: Viceroy1962 folded before Flop (didn't bet)



PokerStars Hand #189423220113: Tournament #2367584539, 9000+1000 Hold'em No Limit - Level XXXV (4000/8000) - 2018/08/01 23:08:53 ET
Table '2367584539 23' 9-max Seat #6 is the button
Seat 3: coolercall1 (116616 in chips) 
Seat 4: hzane (136597 in chips) 
Seat 6: filmguysc (142301 in chips) 
Seat 7: komessi (186228 in chips) 
Seat 8: konakiki (48408 in chips) 
Seat 9: Viceroy1962 (53850 in chips) 
coolercall1: posts the ante 800
hzane: posts the ante 800
filmguysc: posts the ante 800
komessi: posts the ante 800
konakiki: posts the ante 800
Viceroy1962: posts the ante 800
komessi: posts small blind 4000
konakiki: posts big blind 8000
*** HOLE CARDS ***
Dealt to hzane [4c 2c]
Viceroy1962: raises 45050 to 53050 and is all-in
coolercall1: folds 
hzane: folds 
filmguysc: folds 
komessi: folds 
konakiki: folds 
Uncalled bet (45050) returned to Viceroy1962
Viceroy1962 collected 24800 from pot
Viceroy1962: doesn't show hand 
*** SUMMARY ***
Total pot 24800 | Rake 0 
Seat 3: coolercall1 folded before Flop (didn't bet)
Seat 4: hzane folded before Flop (didn't bet)
Seat 6: filmguysc (button) folded before Flop (didn't bet)
Seat 7: komessi (small blind) folded before Flop
Seat 8: konakiki (big blind) folded before Flop
Seat 9: Viceroy1962 collected (24800)



PokerStars Hand #189423223411: Tournament #2367584539, 9000+1000 Hold'em No Limit - Level XXXV (4000/8000) - 2018/08/01 23:09:05 ET
Table '2367584539 23' 9-max Seat #7 is the button
Seat 3: coolercall1 (115816 in chips) 
Seat 4: hzane (135797 in chips) 
Seat 6: filmguysc (141501 in chips) 
Seat 7: komessi (181428 in chips) 
Seat 8: konakiki (39608 in chips) 
Seat 9: Viceroy1962 (69850 in chips) 
coolercall1: posts the ante 800
hzane: posts the ante 800
filmguysc: posts the ante 800
komessi: posts the ante 800
konakiki: posts the ante 800
Viceroy1962: posts the ante 800
konakiki: posts small blind 4000
Viceroy1962: posts big blind 8000
*** HOLE CARDS ***
Dealt to hzane [4s 3s]
coolercall1: raises 16000 to 24000
hzane: folds 
filmguysc: calls 24000
komessi: folds 
konakiki: folds 
Viceroy1962: raises 45050 to 69050 and is all-in
coolercall1: raises 45966 to 115016 and is all-in
filmguysc: folds 
Uncalled bet (45966) returned to coolercall1
*** FLOP *** [8s Ac 4h]
*** TURN *** [8s Ac 4h] [Kd]
*** RIVER *** [8s Ac 4h Kd] [2s]
*** SHOW DOWN ***
Viceroy1962: shows [6c Ad] (a pair of Aces)
coolercall1: shows [Ah 5c] (a pair of Aces - lower kicker)
Viceroy1962 collected 170900 from pot
*** SUMMARY ***
Total pot 170900 | Rake 0 
Board [8s Ac 4h Kd 2s]
Seat 3: coolercall1 showed [Ah 5c] and lost with a pair of Aces
Seat 4: hzane folded before Flop (didn't bet)
Seat 6: filmguysc folded before Flop
Seat 7: komessi (button) folded before Flop (didn't bet)
Seat 8: konakiki (small blind) folded before Flop
Seat 9: Viceroy1962 (big blind) showed [6c Ad] and won (170900) with a pair of Aces



PokerStars Hand #189423229978: Tournament #2367584539, 9000+1000 Hold'em No Limit - Level XXXV (4000/8000) - 2018/08/01 23:09:29 ET
Table '2367584539 23' 9-max Seat #8 is the button
Seat 3: coolercall1 (45966 in chips) 
Seat 4: hzane (134997 in chips) 
Seat 6: filmguysc (116701 in chips) 
Seat 7: komessi (180628 in chips) 
Seat 8: konakiki (34808 in chips) 
Seat 9: Viceroy1962 (170900 in chips) 
coolercall1: posts the ante 800
hzane: posts the ante 800
filmguysc: posts the ante 800
komessi: posts the ante 800
konakiki: posts the ante 800
Viceroy1962: posts the ante 800
Viceroy1962: posts small blind 4000
coolercall1: posts big blind 8000
*** HOLE CARDS ***
Dealt to hzane [As Qc]
filmguysc said, "lol"
hzane: raises 8000 to 16000
filmguysc: folds 
komessi: folds 
konakiki: raises 18008 to 34008 and is all-in
Viceroy1962: folds 
coolercall1: folds 
hzane: calls 18008
*** FLOP *** [Ks 8c Qs]
*** TURN *** [Ks 8c Qs] [Ts]
*** RIVER *** [Ks 8c Qs Ts] [Jh]
*** SHOW DOWN ***
hzane: shows [As Qc] (a straight, Ten to Ace)
konakiki: shows [Jc Kc] (two pair, Kings and Jacks)
hzane collected 84816 from pot
konakiki finished the tournament in 6th place and received 87000.
*** SUMMARY ***
Total pot 84816 | Rake 0 
Board [Ks 8c Qs Ts Jh]
Seat 3: coolercall1 (big blind) folded before Flop
Seat 4: hzane showed [As Qc] and won (84816) with a straight, Ten to Ace
Seat 6: filmguysc folded before Flop (didn't bet)
Seat 7: komessi folded before Flop (didn't bet)
Seat 8: konakiki (button) showed [Jc Kc] and lost with two pair, Kings and Jacks
Seat 9: Viceroy1962 (small blind) folded before Flop



PokerStars Hand #189423237360: Tournament #2367584539, 9000+1000 Hold'em No Limit - Level XXXV (4000/8000) - 2018/08/01 23:09:56 ET
Table '2367584539 23' 9-max Seat #9 is the button
Seat 3: coolercall1 (37166 in chips) 
Seat 4: hzane (185005 in chips) 
Seat 6: filmguysc (115901 in chips) 
Seat 7: komessi (179828 in chips) 
Seat 9: Viceroy1962 (166100 in chips) 
coolercall1: posts the ante 800
hzane: posts the ante 800
filmguysc: posts the ante 800
komessi: posts the ante 800
Viceroy1962: posts the ante 800
coolercall1: posts small blind 4000
hzane: posts big blind 8000
*** HOLE CARDS ***
Dealt to hzane [6h Kh]
filmguysc: folds 
komessi: folds 
Viceroy1962: folds 
filmguysc said, "I would have puked"
coolercall1: raises 28366 to 36366 and is all-in
hzane: folds 
Uncalled bet (28366) returned to coolercall1
coolercall1 collected 20000 from pot
coolercall1: doesn't show hand 
*** SUMMARY ***
Total pot 20000 | Rake 0 
Seat 3: coolercall1 (small blind) collected (20000)
Seat 4: hzane (big blind) folded before Flop
Seat 6: filmguysc folded before Flop (didn't bet)
Seat 7: komessi folded before Flop (didn't bet)
Seat 9: Viceroy1962 (button) folded before Flop (didn't bet)



PokerStars Hand #189423241951: Tournament #2367584539, 9000+1000 Hold'em No Limit - Level XXXV (4000/8000) - 2018/08/01 23:10:13 ET
Table '2367584539 23' 9-max Seat #3 is the button
Seat 3: coolercall1 (48366 in chips) 
Seat 4: hzane (176205 in chips) 
Seat 6: filmguysc (115101 in chips) 
Seat 7: komessi (179028 in chips) 
Seat 9: Viceroy1962 (165300 in chips) 
coolercall1: posts the ante 800
hzane: posts the ante 800
filmguysc: posts the ante 800
komessi: posts the ante 800
Viceroy1962: posts the ante 800
hzane: posts small blind 4000
filmguysc: posts big blind 8000
*** HOLE CARDS ***
Dealt to hzane [9s Ah]
komessi: folds 
Viceroy1962: folds 
coolercall1: folds 
hzane: calls 4000
filmguysc: checks 
*** FLOP *** [7h Jh Qs]
hzane: bets 8000
filmguysc: folds 
Uncalled bet (8000) returned to hzane
hzane collected 20000 from pot
*** SUMMARY ***
Total pot 20000 | Rake 0 
Board [7h Jh Qs]
Seat 3: coolercall1 (button) folded before Flop (didn't bet)
Seat 4: hzane (small blind) collected (20000)
Seat 6: filmguysc (big blind) folded on the Flop
Seat 7: komessi folded before Flop (didn't bet)
Seat 9: Viceroy1962 folded before Flop (didn't bet)



PokerStars Hand #189423246815: Tournament #2367584539, 9000+1000 Hold'em No Limit - Level XXXV (4000/8000) - 2018/08/01 23:10:31 ET
Table '2367584539 23' 9-max Seat #4 is the button
Seat 3: coolercall1 (47566 in chips) 
Seat 4: hzane (187405 in chips) 
Seat 6: filmguysc (106301 in chips) 
Seat 7: komessi (178228 in chips) 
Seat 9: Viceroy1962 (164500 in chips) 
coolercall1: posts the ante 800
hzane: posts the ante 800
filmguysc: posts the ante 800
komessi: posts the ante 800
Viceroy1962: posts the ante 800
filmguysc: posts small blind 4000
komessi: posts big blind 8000
*** HOLE CARDS ***
Dealt to hzane [8s Qd]
Viceroy1962: folds 
coolercall1: folds 
hzane: raises 8000 to 16000
filmguysc: folds 
komessi: calls 8000
*** FLOP *** [2d Qh 6h]
komessi: checks 
hzane: bets 16000
komessi: calls 16000
*** TURN *** [2d Qh 6h] [9d]
komessi: bets 18700
hzane: raises 18700 to 37400
komessi: folds 
Uncalled bet (18700) returned to hzane
hzane collected 109400 from pot
*** SUMMARY ***
Total pot 109400 | Rake 0 
Board [2d Qh 6h 9d]
Seat 3: coolercall1 folded before Flop (didn't bet)
Seat 4: hzane (button) collected (109400)
Seat 6: filmguysc (small blind) folded before Flop
Seat 7: komessi (big blind) folded on the Turn
Seat 9: Viceroy1962 folded before Flop (didn't bet)



PokerStars Hand #189423261790: Tournament #2367584539, 9000+1000 Hold'em No Limit - Level XXXVI (5000/10000) - 2018/08/01 23:11:26 ET
Table '2367584539 23' 9-max Seat #6 is the button
Seat 3: coolercall1 (46766 in chips) 
Seat 4: hzane (245305 in chips) 
Seat 6: filmguysc (101501 in chips) 
Seat 7: komessi (126728 in chips) 
Seat 9: Viceroy1962 (163700 in chips) 
coolercall1: posts the ante 1000
hzane: posts the ante 1000
filmguysc: posts the ante 1000
komessi: posts the ante 1000
Viceroy1962: posts the ante 1000
komessi: posts small blind 5000
Viceroy1962: posts big blind 10000
*** HOLE CARDS ***
Dealt to hzane [Ad Qh]
coolercall1: raises 35766 to 45766 and is all-in
hzane: calls 45766
filmguysc: raises 54735 to 100501 and is all-in
komessi: folds 
Viceroy1962: folds 
hzane: calls 54735
*** FLOP *** [7h 9h 3s]
*** TURN *** [7h 9h 3s] [Kh]
*** RIVER *** [7h 9h 3s Kh] [Qc]
*** SHOW DOWN ***
hzane: shows [Ad Qh] (a pair of Queens)
filmguysc: shows [Th Tc] (a pair of Tens)
hzane collected 109470 from side pot
coolercall1: shows [Jc 8h] (high card King)
hzane collected 157298 from main pot
filmguysc finished the tournament in 4th place and received 141000.
coolercall1 finished the tournament in 5th place and received 108000.
*** SUMMARY ***
Total pot 266768 Main pot 157298. Side pot 109470. | Rake 0 
Board [7h 9h 3s Kh Qc]
Seat 3: coolercall1 showed [Jc 8h] and lost with high card King
Seat 4: hzane showed [Ad Qh] and won (266768) with a pair of Queens
Seat 6: filmguysc (button) showed [Th Tc] and lost with a pair of Tens
Seat 7: komessi (small blind) folded before Flop
Seat 9: Viceroy1962 (big blind) folded before Flop



PokerStars Hand #189423269133: Tournament #2367584539, 9000+1000 Hold'em No Limit - Level XXXVI (5000/10000) - 2018/08/01 23:11:53 ET
Table '2367584539 23' 9-max Seat #7 is the button
Seat 4: hzane (410572 in chips) 
Seat 7: komessi (120728 in chips) 
Seat 9: Viceroy1962 (152700 in chips) 
hzane: posts the ante 1000
komessi: posts the ante 1000
Viceroy1962: posts the ante 1000
Viceroy1962: posts small blind 5000
hzane: posts big blind 10000
*** HOLE CARDS ***
Dealt to hzane [5h 8h]
komessi: folds 
Viceroy1962: calls 5000
hzane: checks 
*** FLOP *** [Ah 9d 6s]
Viceroy1962: bets 10000
hzane: folds 
Uncalled bet (10000) returned to Viceroy1962
Viceroy1962 collected 23000 from pot
Viceroy1962: doesn't show hand 
*** SUMMARY ***
Total pot 23000 | Rake 0 
Board [Ah 9d 6s]
Seat 4: hzane (big blind) folded on the Flop
Seat 7: komessi (button) folded before Flop (didn't bet)
Seat 9: Viceroy1962 (small blind) collected (23000)



PokerStars Hand #189423274961: Tournament #2367584539, 9000+1000 Hold'em No Limit - Level XXXVI (5000/10000) - 2018/08/01 23:12:14 ET
Table '2367584539 23' 9-max Seat #9 is the button
Seat 4: hzane (399572 in chips) 
Seat 7: komessi (119728 in chips) 
Seat 9: Viceroy1962 (164700 in chips) 
hzane: posts the ante 1000
komessi: posts the ante 1000
Viceroy1962: posts the ante 1000
hzane: posts small blind 5000
komessi: posts big blind 10000
*** HOLE CARDS ***
Dealt to hzane [6d Ac]
Viceroy1962: folds 
hzane: calls 5000
komessi: raises 108728 to 118728 and is all-in
hzane: folds 
Uncalled bet (108728) returned to komessi
komessi collected 23000 from pot
komessi: doesn't show hand 
*** SUMMARY ***
Total pot 23000 | Rake 0 
Seat 4: hzane (small blind) folded before Flop
Seat 7: komessi (big blind) collected (23000)
Seat 9: Viceroy1962 (button) folded before Flop (didn't bet)



PokerStars Hand #189423281428: Tournament #2367584539, 9000+1000 Hold'em No Limit - Level XXXVI (5000/10000) - 2018/08/01 23:12:38 ET
Table '2367584539 23' 9-max Seat #4 is the button
Seat 4: hzane (388572 in chips) 
Seat 7: komessi (131728 in chips) 
Seat 9: Viceroy1962 (163700 in chips) 
hzane: posts the ante 1000
komessi: posts the ante 1000
Viceroy1962: posts the ante 1000
komessi: posts small blind 5000
Viceroy1962: posts big blind 10000
*** HOLE CARDS ***
Dealt to hzane [8s 6c]
hzane: folds 
komessi: calls 5000
Viceroy1962: raises 152700 to 162700 and is all-in
komessi: calls 120728 and is all-in
Uncalled bet (31972) returned to Viceroy1962
*** FLOP *** [Th Ks Jd]
*** TURN *** [Th Ks Jd] [8h]
*** RIVER *** [Th Ks Jd 8h] [7c]
*** SHOW DOWN ***
komessi: shows [Kh Kc] (three of a kind, Kings)
Viceroy1962: shows [Kd Ac] (a pair of Kings)
komessi collected 264456 from pot
*** SUMMARY ***
Total pot 264456 | Rake 0 
Board [Th Ks Jd 8h 7c]
Seat 4: hzane (button) folded before Flop (didn't bet)
Seat 7: komessi (small blind) showed [Kh Kc] and won (264456) with three of a kind, Kings
Seat 9: Viceroy1962 (big blind) showed [Kd Ac] and lost with a pair of Kings



PokerStars Hand #189423287079: Tournament #2367584539, 9000+1000 Hold'em No Limit - Level XXXVI (5000/10000) - 2018/08/01 23:12:59 ET
Table '2367584539 23' 9-max Seat #7 is the button
Seat 4: hzane (387572 in chips) 
Seat 7: komessi (264456 in chips) 
Seat 9: Viceroy1962 (31972 in chips) 
hzane: posts the ante 1000
komessi: posts the ante 1000
Viceroy1962: posts the ante 1000
Viceroy1962: posts small blind 5000
hzane: posts big blind 10000
*** HOLE CARDS ***
Dealt to hzane [5d Qc]
komessi: folds 
Viceroy1962: folds 
Uncalled bet (5000) returned to hzane
hzane collected 13000 from pot
*** SUMMARY ***
Total pot 13000 | Rake 0 
Seat 4: hzane (big blind) collected (13000)
Seat 7: komessi (button) folded before Flop (didn't bet)
Seat 9: Viceroy1962 (small blind) folded before Flop



PokerStars Hand #189423289329: Tournament #2367584539, 9000+1000 Hold'em No Limit - Level XXXVI (5000/10000) - 2018/08/01 23:13:08 ET
Table '2367584539 23' 9-max Seat #9 is the button
Seat 4: hzane (394572 in chips) 
Seat 7: komessi (263456 in chips) 
Seat 9: Viceroy1962 (25972 in chips) 
hzane: posts the ante 1000
komessi: posts the ante 1000
Viceroy1962: posts the ante 1000
hzane: posts small blind 5000
komessi: posts big blind 10000
*** HOLE CARDS ***
Dealt to hzane [Js 7d]
Viceroy1962: raises 14972 to 24972 and is all-in
hzane: folds 
komessi: calls 14972
*** FLOP *** [Qd 2d 4c]
*** TURN *** [Qd 2d 4c] [Jh]
*** RIVER *** [Qd 2d 4c Jh] [4d]
*** SHOW DOWN ***
komessi: shows [Kh Ah] (a pair of Fours)
Viceroy1962: shows [Kd 9c] (a pair of Fours - lower kicker)
komessi collected 57944 from pot
Viceroy1962 finished the tournament in 3rd place and received 188000.
*** SUMMARY ***
Total pot 57944 | Rake 0 
Board [Qd 2d 4c Jh 4d]
Seat 4: hzane (small blind) folded before Flop
Seat 7: komessi (big blind) showed [Kh Ah] and won (57944) with a pair of Fours
Seat 9: Viceroy1962 (button) showed [Kd 9c] and lost with a pair of Fours



PokerStars Hand #189423294131: Tournament #2367584539, 9000+1000 Hold'em No Limit - Level XXXVI (5000/10000) - 2018/08/01 23:13:25 ET
Table '2367584539 23' 9-max Seat #7 is the button
Seat 4: hzane (388572 in chips) 
Seat 7: komessi (295428 in chips) 
hzane: posts the ante 1000
komessi: posts the ante 1000
komessi: posts small blind 5000
hzane: posts big blind 10000
*** HOLE CARDS ***
Dealt to hzane [As 9d]
komessi: calls 5000
hzane: raises 10000 to 20000
komessi: calls 10000
*** FLOP *** [8s 8c Qc]
hzane: checks 
komessi: bets 13020
hzane: calls 13020
*** TURN *** [8s 8c Qc] [8d]
hzane: bets 30000
komessi: folds 
Uncalled bet (30000) returned to hzane
hzane collected 68040 from pot
*** SUMMARY ***
Total pot 68040 | Rake 0 
Board [8s 8c Qc 8d]
Seat 4: hzane (big blind) collected (68040)
Seat 7: komessi (button) (small blind) folded on the Turn



PokerStars Hand #189423304977: Tournament #2367584539, 9000+1000 Hold'em No Limit - Level XXXVI (5000/10000) - 2018/08/01 23:14:06 ET
Table '2367584539 23' 9-max Seat #4 is the button
Seat 4: hzane (422592 in chips) 
Seat 7: komessi (261408 in chips) 
hzane: posts the ante 1000
komessi: posts the ante 1000
hzane: posts small blind 5000
komessi: posts big blind 10000
*** HOLE CARDS ***
Dealt to hzane [8s 9c]
hzane: folds 
Uncalled bet (5000) returned to komessi
komessi collected 12000 from pot
komessi: doesn't show hand 
*** SUMMARY ***
Total pot 12000 | Rake 0 
Seat 4: hzane (button) (small blind) folded before Flop
Seat 7: komessi (big blind) collected (12000)



PokerStars Hand #189423306326: Tournament #2367584539, 9000+1000 Hold'em No Limit - Level XXXVI (5000/10000) - 2018/08/01 23:14:11 ET
Table '2367584539 23' 9-max Seat #7 is the button
Seat 4: hzane (416592 in chips) 
Seat 7: komessi (267408 in chips) 
hzane: posts the ante 1000
komessi: posts the ante 1000
komessi: posts small blind 5000
hzane: posts big blind 10000
*** HOLE CARDS ***
Dealt to hzane [Js 4d]
komessi: calls 5000
hzane: checks 
*** FLOP *** [5d 9s 6d]
hzane: checks 
komessi: checks 
*** TURN *** [5d 9s 6d] [Ad]
hzane: checks 
komessi: bets 10780
hzane: folds 
Uncalled bet (10780) returned to komessi
komessi collected 22000 from pot
komessi: doesn't show hand 
*** SUMMARY ***
Total pot 22000 | Rake 0 
Board [5d 9s 6d Ad]
Seat 4: hzane (big blind) folded on the Turn
Seat 7: komessi (button) (small blind) collected (22000)



PokerStars Hand #189423316391: Tournament #2367584539, 9000+1000 Hold'em No Limit - Level XXXVII (6000/12000) - 2018/08/01 23:14:49 ET
Table '2367584539 23' 9-max Seat #4 is the button
Seat 4: hzane (405592 in chips) 
Seat 7: komessi (278408 in chips) 
hzane: posts the ante 1200
komessi: posts the ante 1200
hzane: posts small blind 6000
komessi: posts big blind 12000
*** HOLE CARDS ***
Dealt to hzane [Tc Ts]
hzane: raises 12000 to 24000
komessi: calls 12000
*** FLOP *** [Jh 3s 6h]
komessi: checks 
hzane: bets 12000
komessi: calls 12000
*** TURN *** [Jh 3s 6h] [Qs]
komessi: checks 
hzane: bets 36000
komessi: calls 36000
*** RIVER *** [Jh 3s 6h Qs] [6s]
komessi: checks 
hzane: checks 
*** SHOW DOWN ***
komessi: shows [8s 9s] (a flush, Queen high)
hzane: mucks hand 
komessi collected 146400 from pot
*** SUMMARY ***
Total pot 146400 | Rake 0 
Board [Jh 3s 6h Qs 6s]
Seat 4: hzane (button) (small blind) mucked [Tc Ts]
Seat 7: komessi (big blind) showed [8s 9s] and won (146400) with a flush, Queen high



PokerStars Hand #189423333702: Tournament #2367584539, 9000+1000 Hold'em No Limit - Level XXXVII (6000/12000) - 2018/08/01 23:15:54 ET
Table '2367584539 23' 9-max Seat #7 is the button
Seat 4: hzane (332392 in chips) 
Seat 7: komessi (351608 in chips) 
hzane: posts the ante 1200
komessi: posts the ante 1200
komessi: posts small blind 6000
hzane: posts big blind 12000
*** HOLE CARDS ***
Dealt to hzane [2s Qs]
komessi: calls 6000
hzane: checks 
*** FLOP *** [9c 4c 4s]
hzane: checks 
komessi: bets 12936
hzane: folds 
Uncalled bet (12936) returned to komessi
komessi collected 26400 from pot
komessi: doesn't show hand 
*** SUMMARY ***
Total pot 26400 | Rake 0 
Board [9c 4c 4s]
Seat 4: hzane (big blind) folded on the Flop
Seat 7: komessi (button) (small blind) collected (26400)



PokerStars Hand #189423341072: Tournament #2367584539, 9000+1000 Hold'em No Limit - Level XXXVII (6000/12000) - 2018/08/01 23:16:21 ET
Table '2367584539 23' 9-max Seat #4 is the button
Seat 4: hzane (319192 in chips) 
Seat 7: komessi (364808 in chips) 
hzane: posts the ante 1200
komessi: posts the ante 1200
hzane: posts small blind 6000
komessi: posts big blind 12000
*** HOLE CARDS ***
Dealt to hzane [Qd As]
hzane: raises 12000 to 24000
komessi: folds 
Uncalled bet (12000) returned to hzane
hzane collected 26400 from pot
*** SUMMARY ***
Total pot 26400 | Rake 0 
Seat 4: hzane (button) (small blind) collected (26400)
Seat 7: komessi (big blind) folded before Flop



PokerStars Hand #189423342736: Tournament #2367584539, 9000+1000 Hold'em No Limit - Level XXXVII (6000/12000) - 2018/08/01 23:16:28 ET
Table '2367584539 23' 9-max Seat #7 is the button
Seat 4: hzane (332392 in chips) 
Seat 7: komessi (351608 in chips) 
hzane: posts the ante 1200
komessi: posts the ante 1200
komessi: posts small blind 6000
hzane: posts big blind 12000
*** HOLE CARDS ***
Dealt to hzane [5c 4c]
komessi: raises 14400 to 26400
hzane: calls 14400
*** FLOP *** [8s Td Qd]
hzane: bets 24000
komessi: raises 31992 to 55992
hzane: folds 
Uncalled bet (31992) returned to komessi
komessi collected 103200 from pot
komessi: doesn't show hand 
*** SUMMARY ***
Total pot 103200 | Rake 0 
Board [8s Td Qd]
Seat 4: hzane (big blind) folded on the Flop
Seat 7: komessi (button) (small blind) collected (103200)



PokerStars Hand #189423354591: Tournament #2367584539, 9000+1000 Hold'em No Limit - Level XXXVII (6000/12000) - 2018/08/01 23:17:11 ET
Table '2367584539 23' 9-max Seat #4 is the button
Seat 4: hzane (280792 in chips) 
Seat 7: komessi (403208 in chips) 
hzane: posts the ante 1200
komessi: posts the ante 1200
hzane: posts small blind 6000
komessi: posts big blind 12000
*** HOLE CARDS ***
Dealt to hzane [4h Ts]
hzane: folds 
Uncalled bet (6000) returned to komessi
komessi collected 14400 from pot
komessi: doesn't show hand 
*** SUMMARY ***
Total pot 14400 | Rake 0 
Seat 4: hzane (button) (small blind) folded before Flop
Seat 7: komessi (big blind) collected (14400)



PokerStars Hand #189423355792: Tournament #2367584539, 9000+1000 Hold'em No Limit - Level XXXVII (6000/12000) - 2018/08/01 23:17:16 ET
Table '2367584539 23' 9-max Seat #7 is the button
Seat 4: hzane (273592 in chips) 
Seat 7: komessi (410408 in chips) 
hzane: posts the ante 1200
komessi: posts the ante 1200
komessi: posts small blind 6000
hzane: posts big blind 12000
*** HOLE CARDS ***
Dealt to hzane [2c Th]
komessi: raises 14400 to 26400
hzane: folds 
Uncalled bet (14400) returned to komessi
komessi collected 26400 from pot
komessi: doesn't show hand 
*** SUMMARY ***
Total pot 26400 | Rake 0 
Seat 4: hzane (big blind) folded before Flop
Seat 7: komessi (button) (small blind) collected (26400)



PokerStars Hand #189423358977: Tournament #2367584539, 9000+1000 Hold'em No Limit - Level XXXVIII (7000/14000) - 2018/08/01 23:17:28 ET
Table '2367584539 23' 9-max Seat #4 is the button
Seat 4: hzane (260392 in chips) 
Seat 7: komessi (423608 in chips) 
hzane: posts the ante 1400
komessi: posts the ante 1400
hzane: posts small blind 7000
komessi: posts big blind 14000
*** HOLE CARDS ***
Dealt to hzane [9d 2h]
hzane: folds 
Uncalled bet (7000) returned to komessi
komessi collected 16800 from pot
komessi: doesn't show hand 
*** SUMMARY ***
Total pot 16800 | Rake 0 
Seat 4: hzane (button) (small blind) folded before Flop
Seat 7: komessi (big blind) collected (16800)



PokerStars Hand #189423360134: Tournament #2367584539, 9000+1000 Hold'em No Limit - Level XXXVIII (7000/14000) - 2018/08/01 23:17:32 ET
Table '2367584539 23' 9-max Seat #7 is the button
Seat 4: hzane (251992 in chips) 
Seat 7: komessi (432008 in chips) 
hzane: posts the ante 1400
komessi: posts the ante 1400
komessi: posts small blind 7000
hzane: posts big blind 14000
*** HOLE CARDS ***
Dealt to hzane [6s 3d]
komessi: raises 16800 to 30800
hzane: folds 
Uncalled bet (16800) returned to komessi
komessi collected 30800 from pot
komessi: doesn't show hand 
*** SUMMARY ***
Total pot 30800 | Rake 0 
Seat 4: hzane (big blind) folded before Flop
Seat 7: komessi (button) (small blind) collected (30800)



PokerStars Hand #189423365386: Tournament #2367584539, 9000+1000 Hold'em No Limit - Level XXXVIII (7000/14000) - 2018/08/01 23:17:51 ET
Table '2367584539 23' 9-max Seat #4 is the button
Seat 4: hzane (236592 in chips) 
Seat 7: komessi (447408 in chips) 
hzane: posts the ante 1400
komessi: posts the ante 1400
hzane: posts small blind 7000
komessi: posts big blind 14000
*** HOLE CARDS ***
Dealt to hzane [6s Ad]
hzane: calls 7000
komessi: checks 
*** FLOP *** [Ac As 7s]
komessi: checks 
hzane: checks 
*** TURN *** [Ac As 7s] [7c]
komessi: checks 
hzane: checks 
*** RIVER *** [Ac As 7s 7c] [4c]
komessi: bets 15092
hzane: raises 26908 to 42000
komessi: calls 26908
*** SHOW DOWN ***
hzane: shows [6s Ad] (a full house, Aces full of Sevens)
komessi: mucks hand 
hzane collected 114800 from pot
*** SUMMARY ***
Total pot 114800 | Rake 0 
Board [Ac As 7s 7c 4c]
Seat 4: hzane (button) (small blind) showed [6s Ad] and won (114800) with a full house, Aces full of Sevens
Seat 7: komessi (big blind) mucked [Ts Kh]



PokerStars Hand #189423372527: Tournament #2367584539, 9000+1000 Hold'em No Limit - Level XXXVIII (7000/14000) - 2018/08/01 23:18:18 ET
Table '2367584539 23' 9-max Seat #7 is the button
Seat 4: hzane (293992 in chips) 
Seat 7: komessi (390008 in chips) 
hzane: posts the ante 1400
komessi: posts the ante 1400
komessi: posts small blind 7000
hzane: posts big blind 14000
*** HOLE CARDS ***
Dealt to hzane [9c 2s]
komessi: calls 7000
hzane: checks 
*** FLOP *** [7d 8h 3c]
hzane: bets 14000
komessi: calls 14000
*** TURN *** [7d 8h 3c] [2d]
hzane: bets 14000
komessi: raises 26908 to 40908
hzane: calls 26908
*** RIVER *** [7d 8h 3c 2d] [Ad]
hzane: bets 56000
komessi: folds 
Uncalled bet (56000) returned to hzane
hzane collected 140616 from pot
*** SUMMARY ***
Total pot 140616 | Rake 0 
Board [7d 8h 3c 2d Ad]
Seat 4: hzane (big blind) collected (140616)
Seat 7: komessi (button) (small blind) folded on the River



PokerStars Hand #189423390189: Tournament #2367584539, 9000+1000 Hold'em No Limit - Level XXXVIII (7000/14000) - 2018/08/01 23:19:24 ET
Table '2367584539 23' 9-max Seat #4 is the button
Seat 4: hzane (364300 in chips) 
Seat 7: komessi (319700 in chips) 
hzane: posts the ante 1400
komessi: posts the ante 1400
hzane: posts small blind 7000
komessi: posts big blind 14000
*** HOLE CARDS ***
Dealt to hzane [3s Tc]
hzane: folds 
Uncalled bet (7000) returned to komessi
komessi collected 16800 from pot
komessi: doesn't show hand 
*** SUMMARY ***
Total pot 16800 | Rake 0 
Seat 4: hzane (button) (small blind) folded before Flop
Seat 7: komessi (big blind) collected (16800)



PokerStars Hand #189423391382: Tournament #2367584539, 9000+1000 Hold'em No Limit - Level XXXVIII (7000/14000) - 2018/08/01 23:19:28 ET
Table '2367584539 23' 9-max Seat #7 is the button
Seat 4: hzane (355900 in chips) 
Seat 7: komessi (328100 in chips) 
hzane: posts the ante 1400
komessi: posts the ante 1400
komessi: posts small blind 7000
hzane: posts big blind 14000
*** HOLE CARDS ***
Dealt to hzane [2s 6h]
komessi: calls 7000
hzane: checks 
*** FLOP *** [4c 9c 7d]
hzane: checks 
komessi: bets 15092
hzane: folds 
Uncalled bet (15092) returned to komessi
komessi collected 30800 from pot
komessi: doesn't show hand 
*** SUMMARY ***
Total pot 30800 | Rake 0 
Board [4c 9c 7d]
Seat 4: hzane (big blind) folded on the Flop
Seat 7: komessi (button) (small blind) collected (30800)



PokerStars Hand #189423395194: Tournament #2367584539, 9000+1000 Hold'em No Limit - Level XXXVIII (7000/14000) - 2018/08/01 23:19:42 ET
Table '2367584539 23' 9-max Seat #4 is the button
Seat 4: hzane (340500 in chips) 
Seat 7: komessi (343500 in chips) 
hzane: posts the ante 1400
komessi: posts the ante 1400
hzane: posts small blind 7000
komessi: posts big blind 14000
*** HOLE CARDS ***
Dealt to hzane [3d Qd]
hzane: calls 7000
komessi: checks 
*** FLOP *** [3h 8h Ks]
komessi: checks 
hzane: bets 28000
komessi: folds 
Uncalled bet (28000) returned to hzane
hzane collected 30800 from pot
*** SUMMARY ***
Total pot 30800 | Rake 0 
Board [3h 8h Ks]
Seat 4: hzane (button) (small blind) collected (30800)
Seat 7: komessi (big blind) folded on the Flop



PokerStars Hand #189423398823: Tournament #2367584539, 9000+1000 Hold'em No Limit - Level XXXVIII (7000/14000) - 2018/08/01 23:19:56 ET
Table '2367584539 23' 9-max Seat #7 is the button
Seat 4: hzane (355900 in chips) 
Seat 7: komessi (328100 in chips) 
hzane: posts the ante 1400
komessi: posts the ante 1400
komessi: posts small blind 7000
hzane: posts big blind 14000
*** HOLE CARDS ***
Dealt to hzane [3h Kd]
komessi: raises 16800 to 30800
hzane: calls 16800
*** FLOP *** [Ah Td 8d]
hzane: checks 
komessi: bets 19964
hzane has timed out
hzane: folds 
Uncalled bet (19964) returned to komessi
komessi collected 64400 from pot
komessi: doesn't show hand 
*** SUMMARY ***
Total pot 64400 | Rake 0 
Board [Ah Td 8d]
Seat 4: hzane (big blind) folded on the Flop
Seat 7: komessi (button) (small blind) collected (64400)



PokerStars Hand #189423407487: Tournament #2367584539, 9000+1000 Hold'em No Limit - Level XXXIX (8000/16000) - 2018/08/01 23:20:29 ET
Table '2367584539 23' 9-max Seat #4 is the button
Seat 4: hzane (323700 in chips) 
Seat 7: komessi (360300 in chips) 
hzane: posts the ante 1600
komessi: posts the ante 1600
hzane: posts small blind 8000
komessi: posts big blind 16000
*** HOLE CARDS ***
Dealt to hzane [8d 5d]
hzane: calls 8000
komessi: checks 
*** FLOP *** [Qd Kh 3c]
komessi: checks 
hzane: checks 
*** TURN *** [Qd Kh 3c] [Js]
komessi: bets 17248
hzane: raises 17248 to 34496
komessi: calls 17248
*** RIVER *** [Qd Kh 3c Js] [4s]
komessi: checks 
hzane: bets 48000
komessi: calls 48000
*** SHOW DOWN ***
hzane: shows [8d 5d] (high card King)
komessi: shows [3s 4d] (two pair, Fours and Threes)
komessi collected 200192 from pot
*** SUMMARY ***
Total pot 200192 | Rake 0 
Board [Qd Kh 3c Js 4s]
Seat 4: hzane (button) (small blind) showed [8d 5d] and lost with high card King
Seat 7: komessi (big blind) showed [3s 4d] and won (200192) with two pair, Fours and Threes



PokerStars Hand #189423413515: Tournament #2367584539, 9000+1000 Hold'em No Limit - Level XXXIX (8000/16000) - 2018/08/01 23:20:52 ET
Table '2367584539 23' 9-max Seat #7 is the button
Seat 4: hzane (223604 in chips) 
Seat 7: komessi (460396 in chips) 
hzane: posts the ante 1600
komessi: posts the ante 1600
komessi: posts small blind 8000
hzane: posts big blind 16000
*** HOLE CARDS ***
Dealt to hzane [5d 6d]
komessi: calls 8000
hzane: checks 
*** FLOP *** [6h Tc 8s]
hzane: bets 16000
komessi: raises 32928 to 48928
hzane: folds 
Uncalled bet (32928) returned to komessi
komessi collected 67200 from pot
komessi: doesn't show hand 
*** SUMMARY ***
Total pot 67200 | Rake 0 
Board [6h Tc 8s]
Seat 4: hzane (big blind) folded on the Flop
Seat 7: komessi (button) (small blind) collected (67200)



PokerStars Hand #189423419639: Tournament #2367584539, 9000+1000 Hold'em No Limit - Level XXXIX (8000/16000) - 2018/08/01 23:21:15 ET
Table '2367584539 23' 9-max Seat #4 is the button
Seat 4: hzane (190004 in chips) 
Seat 7: komessi (493996 in chips) 
hzane: posts the ante 1600
komessi: posts the ante 1600
hzane: posts small blind 8000
komessi: posts big blind 16000
*** HOLE CARDS ***
Dealt to hzane [3s 4s]
hzane: calls 8000
komessi: raises 32000 to 48000
hzane: calls 32000
*** FLOP *** [Kh 7d 3c]
komessi: bets 30752
hzane: folds 
Uncalled bet (30752) returned to komessi
komessi collected 99200 from pot
komessi: doesn't show hand 
*** SUMMARY ***
Total pot 99200 | Rake 0 
Board [Kh 7d 3c]
Seat 4: hzane (button) (small blind) folded on the Flop
Seat 7: komessi (big blind) collected (99200)



PokerStars Hand #189423429931: Tournament #2367584539, 9000+1000 Hold'em No Limit - Level XXXIX (8000/16000) - 2018/08/01 23:21:54 ET
Table '2367584539 23' 9-max Seat #7 is the button
Seat 4: hzane (140404 in chips) 
Seat 7: komessi (543596 in chips) 
hzane: posts the ante 1600
komessi: posts the ante 1600
komessi: posts small blind 8000
hzane: posts big blind 16000
*** HOLE CARDS ***
Dealt to hzane [Jh Kc]
komessi: calls 8000
hzane: checks 
*** FLOP *** [6c 9d 4d]
hzane: checks 
komessi: bets 17248
hzane: calls 17248
*** TURN *** [6c 9d 4d] [9c]
hzane: checks 
komessi: bets 34151
hzane: raises 45849 to 80000
komessi: raises 112551 to 192551
hzane: calls 25556 and is all-in
Uncalled bet (86995) returned to komessi
*** RIVER *** [6c 9d 4d 9c] [Ac]
*** SHOW DOWN ***
hzane: shows [Jh Kc] (a pair of Nines)
komessi: shows [Ah Ad] (a full house, Aces full of Nines)
komessi collected 280808 from pot
hzane finished the tournament in 2nd place and received 258000.
komessi wins the tournament and receives 399000 - congratulations!
*** SUMMARY ***
Total pot 280808 | Rake 0 
Board [6c 9d 4d 9c Ac]
Seat 4: hzane (big blind) showed [Jh Kc] and lost with a pair of Nines
Seat 7: komessi (button) (small blind) showed [Ah Ad] and won (280808) with a full house, Aces full of Nines



